::CreateProcess	Create,Process
::DrawThemeTab	Draw,Theme,Tab
::GetFrontWindowOfClass	Get,Front,Window,Of,Class
::GetPrivateProfileSection	Get,Private,Profile,Section
::GetScriptManagerVariable	Get,Script,Manager,Variable
::GetTokenAt	Get,Token,At
::JS_DefineUCProperty	JS,Define,UC,Property
::SetMenuItemHierarchicalID	Set,Menu,Item,Hierarchical,ID
::SetResLoad	Set,Res,Load
::fread	fread
AAS_Error	AAS,Error
AAS_FreeAASLinkedEntities	AAS,Free,AAS,Linked,Entities
ACMButton	ACM,Button
ACString2Double	AC,String,2,Double
AEGetParamDesc	AE,Get,Param,Desc
AF_DEFAULT_TRACK	AF,DEFAULT,TRACK
AIndexExpr	A,Index,Expr
ALLOC	ALLOC
AND_EXP_AST__LINE_START	AND,EXP,AST,LINE,START
APPCOMMAND_BROWSER_REFRESH	APP,COMMAND,BROWSER,REFRESH
APR_FILEPATH_ENCODING_LOCALE	APR,FILE,PATH,ENCODING,LOCALE
APR_POLLSET_THREADSAFE	APR,POLL,SET,THREAD,SAFE
APR_WIN_CE_3	APR,WIN,CE,3
APR_XML_ERROR_EXPAT	APR,XML,ERROR,EXPAT
ARB_shader_objects_glUniform3fARB_pointer	ARB,shader,objects,gl,Uniform,3,f,ARB,pointer
ART_UTA_BBOX_Y0	ART,UTA,BBOX,Y,0
ASENSITIVE_SYM	A,SENSITIVE,SYM
ASE_KeyMESH_ANIMATION	ASE,Key,MESH,ANIMATION
ASTRewrite.TYPE	AST,Rewrite,TYPE
ASTView	AST,View
AST_CDR_DOCUMENTATION	AST,CDR,DOCUMENTATION
AST_FEATURE_DISCONNECT	AST,FEATURE,DISCONNECT
AST_LOCK_FAILURE	AST,LOCK,FAILURE
AST_RTP_MAX	AST,RTP,MAX
ATK_ROLE_MENU	ATK,ROLE,MENU
AUTOMATIC_DATABASE_MEMORY_URL.equals	AUTOMATIC,DATABASE,MEMORY,URL,equals
AVI_ERR_OPEN	AVI,ERR,OPEN
A_RFC931	A,RFC,931
A_zimbraMessageIdDedupeCacheSize	A,zimbra,Message,Id,Dedupe,Cache,Size
Ability.FLAG_AIRBASED	Ability,FLAG,AIR,BASED
AccumulateCRC	Accumulate,CRC
AddBorderPaddingToMaxElementSize	Add,Border,Padding,To,Max,Element,Size
AdminService.MAIL_QUEUE_ACTION_RESPONSE	Admin,Service,MAIL,QUEUE,ACTION,RESPONSE
AdvancedQuickAssistProcessor_addParethesis_description	Advanced,Quick,Assist,Processor,add,Parethesis,description
AnsiToOem	Ansi,To,Oem
ArrayToArrayInfoMap	Array,To,Array,Info,Map
AtkCoordType	Atk,Coord,Type
AtkTextIface	Atk,Text,Iface
AttrInfoIterator	Attr,Info,Iterator
B1unitLengthSidewallJctCap	B,1,unit,Length,Sidewall,Jct,Cap
BARCODE_NO_ASCII	BARCODE,NO,ASCII
BCCellData	BC,Cell,Data
BER_SetFilter	BER,Set,Filter
BIO_CB_RETURN	BIO,CB,RETURN
BIT5_H	BIT,5,H
BMPEncodeLine	BMP,Encode,Line
BOTLIB_AI_ALLOC_CHAT_STATE	BOT,LIB,AI,ALLOC,CHAT,STATE
BOTLIB_PC_LOAD_SOURCE	BOT,LIB,PC,LOAD,SOURCE
BSD_REGEX	BSD,REGEX
BS_PUSHBUTTON	BS,PUSH,BUTTON
BZipUncompress	BZip,Uncompress
BaseExc	Base,Exc
BlastBin2Csv	Blast,Bin,2,Csv
BlockRowPixels	Block,Row,Pixels
BooleanECD	Boolean,ECD
BugBaseQuery.QUERY_UPDATE_BUGREPORTS	Bug,Base,Query,QUERY,UPDATE,BUG,REPORTS
BulletinConstants.TAGSTATUS	Bulletin,Constants,TAG,STATUS
CAInfo.SELFSIGNED	CA,Info,SELF,SIGNED
CBM_INIT	CBM,INIT
CBuilderXProjectWriter	C,Builder,X,Project,Writer
CCLASS_UPPER	C,CLASS,UPPER
CCollectionViewDialog	C,Collection,View,Dialog
CDSC_PSADOBE	CDSC,PS,ADOBE
CELLTYPE_BODY	CELL,TYPE,BODY
CERTAuthInfoAccess	CERT,Auth,Info,Access
CERT_DecodeCertificatePoliciesExtension	CERT,Decode,Certificate,Policies,Extension
CERT_SaveSMimeProfile	CERT,Save,S,Mime,Profile
CEditor_SetPos	C,Editor,Set,Pos
CFArrayCreateMutable	CF,Array,Create,Mutable
CFPAnalyser	CFP,Analyser
CFriendListCtrl	C,Friend,List,Ctrl
CGConstants.MAX_CARDINALITY_COLOR	CGConstants,MAX,CARDINALITY,COLOR
CG_CalcMuzzlePoint	CG,Calc,Muzzle,Point
CG_Printf	CG,Printf
CHANSPY_TRIGGER_READ	CHANSPY,TRIGGER,READ
CHAR_DIAPRE_DECIMALE	CHAR,DIAPRE,DECIMALE
CHECK_SERVICE_USE_OK	CHECK,SERVICE,USE,OK
CHOICEHELP	CHOICE,HELP
CHROME_DIR_NAME	CHROME,DIR,NAME
CHU_ERR_ERROR	CHU,ERR,ERROR
CI_SIGNATURE	CI,SIGNATURE
CKM_SHA384_HMAC	CKM,SHA,384,HMAC
CK_C_INITIALIZE_ARGS	CK,C,INITIALIZE,ARGS
CLASSTYPE_FRIEND_CLASSES	CLASS,TYPE,FRIEND,CLASSES
CLIENT_SSL	CLIENT,SSL
CLIENT_THREADS_MIN	CLIENT,THREADS,MIN
CLabelTab	CLabel,Tab
CM_BoundBrush	CM,Bound,Brush
CNumPad.FUNC_CLR	C,Num,Pad,FUNC,CLR
CODEC_MSZH	CODEC,MSZH
CODE_null_unit_attr	CODE,null,unit,attr
COLLECTION_COMPLEX_TYPE_AST__PCOLLECTION_KEY	COLLECTION,COMPLEX,TYPE,AST,PCOLLECTION,KEY
COMPUTIME_FORMAT	COMPU,TIME,FORMAT
CONTINUE_PREV	CONTINUE,PREV
CONV_OLD_CONVERT	CONV,OLD,CONVERT
COSBasedObject.MetaClass	COS,Based,Object,Meta,Class
CPU_features.i387	CPU,features,i,387
CRMF_CertReqMsgSetKeyEnciphermentPOP	CRMF,Cert,Req,Msg,Set,Key,Encipherment,POP
CSS_PROP_XUL	CSS,PROP,XUL
CSS_STATE_DELETED	CSS,STATE,DELETED
CSearchDlg	C,Search,Dlg
CSimpleKnownFileArray	C,Simple,Known,File,Array
CStyleToken	C,Style,Token
CTL_HOME	CTL,HOME
CWColormap	CW,Color,map
CalcDiffInTotals	Calc,Diff,In,Totals
CalcHorCornerOffset	Calc,Hor,Corner,Offset
CalcSize	Calc,Size
CallNPN_PostURLProc	Call,NPN,Post,URL,Proc
Cam_MouseDown	Cam,Mouse,Down
CameraPhoneOntologyApp	Camera,Phone,Ontology,App
Cbcalc	Cb,calc
CdlPackage.VARIABLE__SEMANTIC_ANNOTATIONS	Cdl,Package,VARIABLE,SEMANTIC,ANNOTATIONS
CharImpl	Char,Impl
ChildLocalHome.JNDI_NAME	Child,Local,Home,JNDI,NAME
ChildParentChooserWindow	Child,Parent,Chooser,Window
ChildrenHashOps	Children,Hash,Ops
ClassDescriptor.OOS_ARGS	Class,Descriptor,OOS,ARGS
ClassType.ANNOTATION_TYPE_DECL	Class,Type,ANNOTATION,TYPE,DECL
CleanUpBeforeReflow	Clean,Up,Before,Reflow
CobolKinds	Cobol,Kinds
Com_EndParseSession	Com,End,Parse,Session
CommonMainRoutine	Common,Main,Routine
ComponentBinderImplTest	Component,Binder,Impl,Test
Cond_traverser	Cond,traverser
ConfigParser.QUERY_CACHE_MAX_QUERIES	Config,Parser,QUERY,CACHE,MAX,QUERIES
ConfigurationUtil.SKINS_XML	Configuration,Util,SKINS,XML
Console_IO.str_emph	Console,IO,str,emph
ConstTipoMensajes.OBJ_NUEVO	Const,Tipo,Mensajes,OBJ,NUEVO
Constants.ACK_BYTES.length	Constants,ACK,BYTES,length
Constants.ATTR_CLASS_VALUE_SOURCE	Constants,ATTR,CLASS,VALUE,SOURCE
Constants.FSWP	Constants,FSWP
Constants.JUNIT_DOUBLE_PRECISION	Constants,JUNIT,DOUBLE,PRECISION
Constants.MHS_OR_ADDRESS_OID	Constants,MHS,OR,ADDRESS,OID
Constants.amountOf	Constants,amount,Of
ConstructAttributeTable	Construct,Attribute,Table
ConvertToAUTF8String	Convert,To,AUTF,8,String
CountRectProc	Count,Rect,Proc
Crawler.WEB	Crawler,WEB
CreateImapManageMailAccountUrl	Create,Imap,Manage,Mail,Account,Url
CreatePopupMenu	Create,Popup,Menu
CreateSVGTransform	Create,SVG,Transform
DAlarmFields	D,Alarm,Fields
DB_RECOVER	DB,RECOVER
DB_VERB_CHKPOINT	DB,VERB,CHKPOINT
DCF_M	DCF,M
DC_COMMENT	DC,COMMENT
DC_OPEN	DC,OPEN
DDX_CBIndex	DDX,CB,Index
DECL_ARG_TYPE	DECL,ARG,TYPE
DECL_FIELD_SIZE	DECL,FIELD,SIZE
DELETE_MEDICATION	DELETE,MEDICATION
DES_CBC_Decryption	DES,CBC,Decryption
DICT_POOL_PER_VARYING	DICT,POOL,PER,VARYING
DIFFTYPE_REMOTE	DIFF,TYPE,REMOTE
DIRECTION_NOTSET	DIRECTION,NOT,SET
DJP_NEXT_STRUCTP	DJP,NEXT,STRUCTP
DKGREEN	DK,GREEN
DK_Count	DK,Count
DLG_ADVANCED_SETTINGS	DLG,ADVANCED,SETTINGS
DLList	DL,List
DND_DispatchEvent	DND,Dispatch,Event
DPR_OUTPUT_URL_PARAMETER_NAME	DPR,OUTPUT,URL,PARAMETER,NAME
DRIVE_REMOVABLE	DRIVE,REMOVABLE
DT_DEBUG	DT,DEBUG
DYN_ANY_FACTORY_NAME	DYN,ANY,FACTORY,NAME
DataCollectionConfigFactory	Data,Collection,Config,Factory
DataPackageResources_de	Data,Package,Resources,de
DbMapper.ATTRIBUTE_MAP_OWNER_ATTRIBUTE	Db,Mapper,ATTRIBUTE,MAP,OWNER,ATTRIBUTE
Db_h_hash_callback	Db,h,hash,callback
DecimateConfig	Decimate,Config
DefDlgProc	Def,Dlg,Proc
DefNodeWidth	Def,Node,Width
DeleteModalityLanguageSupportAction	Delete,Modality,Language,Support,Action
DenoiseFFTWindow	Denoise,FFT,Window
DestroyFlushEvent	Destroy,Flush,Event
DestroyOidSequence	Destroy,Oid,Sequence
DialerCommand.CLT_UNBLOCK	Dialer,Command,CLT,UNBLOCK
DidBeginBatchNotify	Did,Begin,Batch,Notify
DjentelParserEngineTreeConstants.JJTINDENT	Djentel,Parser,Engine,Tree,Constants,JJTINDENT
DoHooks	Do,Hooks
DosSetRelMaxFH	Dos,Set,Rel,Max,FH
DropDownListSpriteCO	Drop,Down,List,Sprite,CO
DublinCoreExtension	Dublin,Core,Extension
DummyListUI	Dummy,List,UI
DynamicProgramming	Dynamic,Programming
EAGAIN	EA,GAIN
ECField	EC,Field
EC_group_fp	EC,group,fp
EDWIN	ED,WIN
EF_LOST	EF,LOST
EL3RST	EL,3,RST
ENETDOWN	E,NET,DOWN
ENVVERB	ENV,VERB
EOPNOTSUPP	EOP,NOT,SUPP
ERROR_LOCK_PATH	ERROR,LOCK,PATH
ERR_INVALID_USERNAME	ERR,INVALID,USERNAME
ERR_MALFORMED_PARAMS	ERR,MALFORMED,PARAMS
ER_ILLEGAL_REFERENCE	ER,ILLEGAL,REFERENCE
ER_LTP	ER,LTP
ESR_NORMAL_FONT_SIZE_DEFAULT	ESR,NORMAL,FONT,SIZE,DEFAULT
ESTRANGELO_SYRIAC	ESTRANGELO,SYRIAC
EUCKR_TYPICAL_DISTRIBUTION_RATIO	EUCKR,TYPICAL,DISTRIBUTION,RATIO
EUDORAIMPORT_ADDRESS_BADSOURCEFILE	EUDORA,IMPORT,ADDRESS,BAD,SOURCE,FILE
EVENT_ATK_TABLE_ROW_REORDER	EVENT,ATK,TABLE,ROW,REORDER
EhSymTable	Eh,Sym,Table
EncodeABC.value.const_refs	Encode,ABC,value,const,refs
Enum.INT_ABOVE	Enum,INT,ABOVE
ErrTimeout	Err,Timeout
ExportXMIReferenceProvider	Export,XMI,Reference,Provider
FARPROC	FAR,PROC
FC_DBG_CACHEV	FC,DBG,CACHEV
FC_USERID_HINT	FC,USER,ID,HINT
FFEBAD_INTRINSIC_AMBIG	FFEBAD,INTRINSIC,AMBIG
FFECOM_f2ccodeCHAR	FFE,COM,f,2,ccode,CHAR
FFEEXPR_percentVAL_	FFE,EXPR,percent,VAL
FFESTR_firstACCEPT	FFE,STR,first,ACCEPT
FFESTR_firstCALL	FFE,STR,first,CALL
FFESTR_genioSIZE	FFESTR,genio,SIZE
FF_LOSS_COLORSPACE	FF,LOSS,COLORSPACE
FHBLK	FHBLK
FIRST_UNARY_EXPRESSION	FIRST,UNARY,EXPRESSION
FM_DEFN_ARABIC	FM,DEFN,ARABIC
FNSYM	FN,SYM
FONTENCODING_EUC_JP_get	FONT,ENCODING,EUC,JP,get
FORMATTER_BRACE_POSITION_FOR_ANNOTATION_TYPE_DECLARATION	FORMATTER,BRACE,POSITION,FOR,ANNOTATION,TYPE,DECLARATION
FORM_DATAOBJECT_CONSTRUCTOR	FORM,DATA,OBJECT,CONSTRUCTOR
FPUL_REGS	FPUL,REGS
FSMultipartFormDataReader	FS,Multipart,Form,Data,Reader
FT_New_Stream	FT,New,Stream
FT_Outline_Oblique	FT,Outline,Oblique
FT_Set_MM_Design_Func	FT,Set,MM,Design,Func
FX_SPELL_PARALYZE	FX,SPELL,PARALYZE
F_GSTRING	F,GSTRING
FileActivator	File,Activator
FileMgrConstants.VMODULE_ACTION_SAVE	File,Mgr,Constants,V,MODULE,ACTION,SAVE
FillKeyValueSecNameKeyID	Fill,Key,Value,Sec,Name,Key,ID
FilterStructuralBrushesIntoTree	Filter,Structural,Brushes,Into,Tree
FindEventHandler	Find,Event,Handler
FlowchartDiagramEditorPlugin.ID	Flowchart,Diagram,Editor,Plugin,ID
FolderBO	Folder,BO
FontNameToType8CmapName	Font,Name,To,Type,8,Cmap,Name
ForrestManager.COMMAND_BUILD	Forrest,Manager,COMMAND,BUILD
FreeverbGain	Free,verb,Gain
FreeverbWindow	Free,verb,Window
GC_push_all_stack_partially_eager	GC,push,all,stack,partially,eager
GC_register_disappearing_link	GC,register,disappearing,link
GConfClientGetDefaultType	G,Conf,Client,Get,Default,Type
GFXBYTESPERPIXEL	GFX,BYTES,PER,PIXEL
GGGPP_CDMA2000	GGGPP,CDMA,2000
GL_COLOR	GL,COLOR
GL_COLOR_BUFFER_BIT	GL,COLOR,BUFFER,BIT
GL_TEXTURE_MAG_FILTER	GL,TEXTURE,MAG,FILTER
GPUndoManager	GP,Undo,Manager
GSN_FSAPPENDCONF	GSN,FS,APPEND,CONF
GSN_FSAPPENDREQ	GSN,FS,APPEND,REQ
GSN_LQH_TRANSCONF	GSN,LQH,TRANSCONF
GSN_LQH_TRANSREQ	GSN,LQH,TRANS,REQ
GSN_STOP_PERM_REF	GSN,STOP,PERM,REF
GTK_JUSTIFY_LEFT	GTK,JUSTIFY,LEFT
GTK_MOZ_EMBED_FLAG_TOOLBARON	GTK,MOZ,EMBED,FLAG,TOOL,BARON
G_DATE_BAD_MONTH	G,DATE,BAD,MONTH
Gaussian03Format	Gaussian,03,Format
GdkEventScroll	Gdk,Event,Scroll
GenModFigure	Gen,Mod,Figure
GetAtkSignalName	Get,Atk,Signal,Name
GetAudioSamplesPerSec	Get,Audio,Samples,Per,Sec
GetCapabilitiesKvpRequestReader	Get,Capabilities,Kvp,Request,Reader
GetContentScrollbarVisibility	Get,Content,Scrollbar,Visibility
GetDistList	Get,Dist,List
GetFirstEv	Get,First,Ev
GetHighestInlineParent	Get,Highest,Inline,Parent
GetMailAccountUrl	Get,Mail,Account,Url
GetMenuType	Get,Menu,Type
GetMinRowHeight	Get,Min,Row,Height
GetNormalizedPathSegList	Get,Normalized,Path,Seg,List
GetOfflineOpForKey	Get,Offline,Op,For,Key
GetPasswordKeyCallback	Get,Password,Key,Callback
GetPrefType	Get,Pref,Type
GetRuntime	Get,Runtime
GetTransferringSrcCount	Get,Transferring,Src,Count
GetUpData_MLDONKEY	Get,Up,Data,ML,DONKEY
GetVopIntraDCVlcThr	Get,Vop,Intra,DCVlc,Thr
GetWSIsEnabled	Get,WSIs,Enabled
GtkStateType	Gtk,State,Type
Gvp	Gvp
HAVE_DECL_SYS_SIGLIST	HAVE,DECL,SYS,SIG,LIST
HAVE_ENDIAN_H	HAVE,ENDIAN,H
HAVE_MMXEXT	HAVE,MMX,EXT
HAVE_trunctfdf2	HAVE,trunc,tfdf,2
HF_LAMBDAFN	HF,LAMBDA,FN
HITField.Description	HIT,Field,Description
HRTIMER_LIB	HR,TIMER,LIB
HSoundsPreferencePanel	HSounds,Preference,Panel
HTTPD_USER	HTTPD,USER
HWM_GROUP	HWM,GROUP
HZ_STATE_GB	HZ,STATE,GB
HandleQueryReconversion	Handle,Query,Reconversion
HandleUnregisterURLEchoEvent	Handle,Unregister,URL,Echo,Event
HardcodedCharacterLiteralsRuleFixTestCase	Hardcoded,Character,Literals,Rule,Fix,Test,Case
HistogramConfig	Histogram,Config
Huff_Init	Huff,Init
IAX_IE_CALLED_CONTEXT	IAX,IE,CALLED,CONTEXT
IActionProvider	I,Action,Provider
ICY_METADATA_INTERVAL	ICY,METADATA,INTERVAL
IClientDataItem	I,Client,Data,Item
ICmdPart	I,Cmd,Part
ID3FID_YEAR	ID,3,FID,YEAR
IDC_COLLECTIONVIEWAUTHORLABEL	IDC,COLLECTION,VIEW,AUTHOR,LABEL
IDC_EDIT_DATETIME	IDC,EDIT,DATE,TIME
IDC_EDIT_QUAKE2	IDC,EDIT,QUAKE,2
IDC_METANAME	IDC,META,NAME
IDC_SPIN_VSCALE	IDC,SPIN,V,SCALE
IDC_TEXTWIN_COPY	IDC,TEXT,WIN,COPY
IDC_UPDATESERVERCLIENT	IDC,UPDATE,SERVER,CLIENT
IDD_PPG_FILES	IDD,PPG,FILES
IDI_TESTPASSED	IDI,TEST,PASSED
IDI_UNINSTALL	IDI,UNINSTALL
IDL_node_new	IDL,node,new
IDL_type_fixed_new	IDL,type,fixed,new
IDS_CMT_AIDE	IDS,CMT,AIDE
IDS_DL_RESUMENEXT	IDS,DL,RESUMENEXT
IDS_FAILEDREOPEN	IDS,FAILED,REOPEN
IDS_HSAV	IDS,HSAV
IDS_IMP_ERR_IO	IDS,IMP,ERR,IO
IDS_IP_HITS	IDS,IP,HITS
IDS_IRC_DISCONNECT	IDS,IRC,DISCONNECT
IDS_LASTSEEN	IDS,LAST,SEEN
IDS_SEARCH_MISSINGORRIGHT	IDS,SEARCH,MISSING,OR,RIGHT
IDS_SOCKETS_INIT_FAILED	IDS,SOCKETS,INIT,FAILED
IEC61883_AMDTP_FORMAT_IEC958_PCM	IEC,61883,AMDTP,FORMAT,IEC,958,PCM
IFF_INUSE	IFF,IN,USE
IFTypeManager.IF_ATTACHMENTS	IF,Type,Manager,IF,ATTACHMENTS
IID_IHTMLElementCollection	IID,I,HTML,Element,Collection
IMAGE_BITMAP	IMAGE,BITMAP
IMAGE_NT_OPTIONAL_HDR_MAGIC	IMAGE,NT,OPTIONAL,HDR,MAGIC
IMAGE_PNG	IMAGE,PNG
INIT_BLOCK_SIZE	INIT,BLOCK,SIZE
INIT_DEBUG_PROPERTIES	INIT,DEBUG,PROPERTIES
INSERT_PROJECT_TYPE	INSERT,PROJECT,TYPE
INTEL_SPINLOCKS	INTEL,SPINLOCKS
INT_ROW_HOLIDAYS_START	INT,ROW,HOLIDAYS,START
IPC_PlatformSendMsg	IPC,Platform,Send,Msg
IP_DROP_MEMBERSHIP	IP,DROP,MEMBERSHIP
IRCMessageTypes.MSG_REHASH	IRC,Message,Types,MSG,REHASH
ISBADADR	IS,BAD,ADR
ISceneManager_addOctTreeSceneNode__SWIG_0	I,Scene,Manager,add,Oct,Tree,Scene,Node,SWIG,0
ITEM_TEXTSTYLE_SHADOWEDMORE	ITEM,TEXT,STYLE,SHADOWED,MORE
ITagLibErrors	ITag,Lib,Errors
IXPathProcessor	IX,Path,Processor
IbisSerializationOutputStream.enumClass	Ibis,Serialization,Output,Stream,enum,Class
ImageMatrix.yy	Image,Matrix,yy
ImageToPDF	Image,To,PDF
ImportInfo.TRIPLIST_ONE_1OBS	Import,Info,TRIPLIST,ONE,1,OBS
Individual.NOT_INHERITABLE	Individual,NOT,INHERITABLE
InitBrowserMenu	Init,Browser,Menu
InitCCITTFax3	Init,CCITT,Fax,3
InitFuncPtrs	Init,Func,Ptrs
InitLicTxt	Init,Lic,Txt
InitTest4.counter2	Init,Test,4,counter,2
InitThread	Init,Thread
Inn_stk	Inn,stk
InscritosListaViewModel	Inscritos,Lista,View,Model
InstantiationSet	Instantiation,Set
IonoStationEditAction	Iono,Station,Edit,Action
Is7bitNonAsciiString	Is,7,bit,Non,Ascii,String
IsHandle	Is,Handle
ItbisEvent.EDITAR	Itbis,Event,EDITAR
Item_func_lt	Item,func,lt
JAVA_SIGNATURE_UNKNOWN	JAVA,SIGNATURE,UNKNOWN
JAVA_T	JAVA,T
JAWE_AUTOSAVE_PROPERTYFILE_NAME	JAWE,AUTOSAVE,PROPERTY,FILE,NAME
JCEProviderObject	JCE,Provider,Object
JCasFunctionTag	JCas,Function,Tag
JDBCAppender.PASSWORD_OPTION	JDBC,Appender,PASSWORD,OPTION
JDBMObjectManagerTestCase	JDBM,Object,Manager,Test,Case
JMPOFFM	JMP,OFF,M
JRMeterChartFactory	JR,Meter,Chart,Factory
JSD_GetJSScript	JSD,Get,JS,Script
JSFUN_LAMBDA	JS,FUN,LAMBDA
JSJMSG_JCLASS_PROP_DELETE	JSJMSG,JCLASS,PROP,DELETE
JSMSG_BAD_TYPE	JS,MSG,BAD,TYPE
JSMSG_COLON_AFTER_ID	JS,MSG,COLON,AFTER,ID
JSPRegularExpressions.HTML_A_PATTERN	JSP,Regular,Expressions,HTML,A,PATTERN
JS_GetFrameAnnotation	JS,Get,Frame,Annotation
JS_NEW_LOCK	JS,NEW,LOCK
JS_XDRCString	JS,XDRC,String
JTRC_ADOBE	JTRC,ADOBE
JVMV_SUN	JVMV,SUN
JVM_ShowPrefsWindow	JVM,Show,Prefs,Window
JXBroadcast	JX,Broadcast
JameleonScriptExceptionTest	Jameleon,Script,Exception,Test
Java2ObjectTypeConverter	Java,2,Object,Type,Converter
JavaPackage_methods	Java,Package,methods
Java_gui_JMouseWheelFrame_setHook	Java,gui,JMouse,Wheel,Frame,set,Hook
Java_yager_utils_GL_glLightfv	Java,yager,utils,GL,gl,Light,fv
JavassistInstrumentorEngineTaskTest	Javassist,Instrumentor,Engine,Task,Test
JmiChangeSet	Jmi,Change,Set
KERN_PAIR_KPY	KERN,PAIR,KPY
KeyFallback	Key,Fallback
Keyboard.KEY_LCONTROL	Keyboard,KEY,L,CONTROL
Krb5.REALM_NULL	Krb,5,REALM,NULL
L1_WO_WAEN	L,1,WO,WAEN
LARGE_NUM_SOCKETS	LARGE,NUM,SOCKETS
LBCarryMask	LB,Carry,Mask
LC_LOAD_DYLIB	LC,LOAD,DYLIB
LDAP_CONTROL_PWEXPIRED	LDAP,CONTROL,PW,EXPIRED
LDAP_SIZELIMIT_EXCEEDED	LDAP,SIZE,LIMIT,EXCEEDED
LDAP_URL_ERR_BADSCOPE	LDAP,URL,ERR,BAD,SCOPE
LEX_INFINITY	LEX,INFINITY
LIBERIA_ID	LIBERIA,ID
LIS_SUCCESS	LIS,SUCCESS
LL_DEBUG	LL,DEBUG
LMTOS_LCP_CONCLUDING	LMTOS,LCP,CONCLUDING
LM_SELECTITEM	LM,SELECT,ITEM
LOADCHOICES	LOAD,CHOICES
LOCKED_DBT	LOCKED,DBT
LOCKED_OBJ_GET_PROTO	LOCKED,OBJ,GET,PROTO
LOGON_PRIVILEGE_NAME	LOGON,PRIVILEGE,NAME
LOOKUPEND	LOOKUP,END
LOOKUP_COMPLETE	LOOKUP,COMPLETE
LPCM_AUDIO	LPCM,AUDIO
LPHANDLE	LP,HANDLE
LProgressBar	L,Progress,Bar
LSold.Mode	L,Sold,Mode
LTRA_MOD_LEN	LTRA,MOD,LEN
LTRAmPTable	LTRA,m,P,Table
LVBKIMAGE	LVBK,IMAGE
LVS_OWNERDATA	LVS,OWNER,DATA
Launch.OS_LINUX	Launch,OS,LINUX
LdapAttrbConst.ATTRIBUTE_MULTI_VALUED	Ldap,Attrb,Const,ATTRIBUTE,MULTI,VALUED
Link.INVERSEPROP	Link,INVERSE,PROP
LogReaderSOAPService	Log,Reader,SOAP,Service
LwCustomView	Lw,Custom,View
MAC_STARTUP	MAC,STARTUP
MAI_ATK_TYPE_NAME_LEN	MAI,ATK,TYPE,NAME,LEN
MALAY	MALAY
MAPI_BCC	MAPI,BCC
MAP_VIEW_CENTRE_LONG	MAP,VIEW,CENTRE,LONG
MATROSKA_CODEC_ID_AUDIO_MPEG2	MATROSKA,CODEC,ID,AUDIO,MPEG,2
MAXUSERNAMELEN	MAX,USERNAME,LEN
MAX_INFO_VALUE	MAX,INFO,VALUE
MAX_LOCATIONS	MAX,LOCATIONS
MAX_URI_SIZE	MAX,URI,SIZE
MAX_VALUE.getMinutes	MAX,VALUE,get,Minutes
MD.Tempo	MD,Tempo
MESSAGE_TYPE_STOP_ASSOC	MESSAGE,TYPE,STOP,ASSOC
MFBFORMAT.setFillPattern	MFB,FORMAT,set,Fill,Pattern
MF_ENABLED	MF,ENABLED
MIDIError	MIDI,Error
MIFValueSetter	MIF,Value,Setter
MIME_URL	MIME,URL
MINPERCENTAGE_TOTRUST	MIN,PERCENTAGE,TO,TRUST
MIN_NUMBER_OF_SIG_PER_DO_JOB	MIN,NUMBER,OF,SIG,PER,DO,JOB
MIN_PROBABILITY	MIN,PROBABILITY
MI_INDEX_BLOCK_MARGIN	MI,INDEX,BLOCK,MARGIN
MJ_FAILED_MARSHALING	MJ,FAILED,MARSHALING
MK_LDAP_OBJECT_CLASS	MK,LDAP,OBJECT,CLASS
MLetTag.ArgTag	M,Let,Tag,Arg,Tag
MNG_CANNOTBEEMPTY	MNG,CANNOT,BE,EMPTY
MNG_FN_INIT_SEEK	MNG,FN,INIT,SEEK
MNG_FN_PROCESS_DISPLAY_TRNS	MNG,FN,PROCESS,DISPLAY,TRNS
MNG_FN_WRITE_FRAM	MNG,FN,WRITE,FRAM
MNG_FN_WRITE_JDAT	MNG,FN,WRITE,JDAT
MOS1phiGiven	MOS,1,phi,Given
MOS2_CQBD	MOS,2,CQBD
MOS2bulkJctPotential	MOS,2,bulk,Jct,Potential
MOS3_VGS	MOS,3,VGS
MOZILLA_VERSION_PROP	MOZILLA,VERSION,PROP
MOZ_CURSOR_HAND_GRABBING	MOZ,CURSOR,HAND,GRABBING
MOZ_PERSONAL_DICT_NAME	MOZ,PERSONAL,DICT,NAME
MP4GetTrackDuration	MP,4,Get,Track,Duration
MP4SetTrackTimeScale	MP,4,Set,Track,Time,Scale
MP4TableProperty	MP,4,Table,Property
MPEG1_BUFFERINFO_LENGTH	MPEG,1,BUFFER,INFO,LENGTH
MPEG2EncCmdLineOptions	MPEG,2,Enc,Cmd,Line,Options
MP_RESUMENEXT	MP,RESUME,NEXT
MSG_DNS_LOOKUP_COMPLETE	MSG,DNS,LOOKUP,COMPLETE
MY_KEEP_PREALLOC	MY,KEEP,PREALLOC
MY_LEX_END_LONG_COMMENT	MY,LEX,END,LONG,COMMENT
MailboxImpl	Mailbox,Impl
MaskDict.Height	Mask,Dict,Height
MaxNoOfAttemptsC	Max,No,Of,Attempts,C
MedlineImporter	Medline,Importer
MenuBuilder.ATTACK_MENU_RELATED_DEST_1	Menu,Builder,ATTACK,MENU,RELATED,DEST,1
MenuItemInfo.cch	Menu,Item,Info,cch
MetaDoorExceptionHandler	Meta,Door,Exception,Handler
MimeMultipartSignedCMS_initialize	Mime,Multipart,Signed,CMS,initialize
MkdirInstallOp	Mk,dir,Install,Op
ModifiableTableChangeEvent	Modifiable,Table,Change,Event
MyAFPXVolMountInfoPtr	My,AFPX,Vol,Mount,Info,Ptr
NAMEKeyword	NAME,Keyword
NAME_STATE	NAME,STATE
NDB_LE_LCPFragmentCompleted	NDB,LE,LCP,Fragment,Completed
NDB_LE_StartPhaseCompleted	NDB,LE,Start,Phase,Completed
NDB_MGM_ILLEGAL_EVENT_SEVERITY	NDB,MGM,ILLEGAL,EVENT,SEVERITY
NEWGROUPS_TIME_OFFSET	NEWGROUPS,TIME,OFFSET
NMEA_strings	NMEA,strings
NNTP_LOGIN_RESPONSE	NNTP,LOGIN,RESPONSE
NNTP_PROFILE_DELETE	NNTP,PROFILE,DELETE
NOFUN	NO,FUN
NSCP_MAPIDeleteMail	NSCP,MAPI,Delete,Mail
NSC_SEARCH_BLOCK_SIZE	NSC,SEARCH,BLOCK,SIZE
NSC_SignEncryptUpdate	NSC,Sign,Encrypt,Update
NSSCMSRecipientInfoID_KeyTrans	NSSCMS,Recipient,Info,ID,Key,Trans
NSSPublicKey_FindCertificates	NSS,Public,Key,Find,Certificates
NSSTrustDomain_DisableToken	NSS,Trust,Domain,Disable,Token
NSS_CMSDigestContext_FinishSingle	NSS,CMS,Digest,Context,Finish,Single
NSS_CMSSignedData_Decode_AfterData	NSS,CMS,Signed,Data,Decode,After,Data
NSTEMPLATEMATCHREFSET_METER	N,STEM,PLATE,MATCH,REF,SET,METER
NS_CHARSET_DETECTOR_CONTRACTID_BASE	NS,CHAR,SET,DETECTOR,CONTRACT,ID,BASE
NS_COMMANDLINE_SERVICE_CID	NS,COMMAND,LINE,SERVICE,CID
NS_DECL_NSIDOMSVGPATHSEGMOVETOREL	NS,DECL,NSI,DOM,SVG,PATH,SEG,MOVE,TO,REL
NS_DECL_NSIWMPSETTINGS	NS,DECL,NSI,WMP,SETTINGS
NS_ERRORSERVICE_CONTRACTID	NS,ERROR,SERVICE,CONTRACT,ID
NS_FILE_FAILURE	NS,FILE,FAILURE
NS_FRAME_IS_COMPLETE	NS,FRAME,IS,COMPLETE
NS_FRAME_TRACE_REFLOW_OUT	NS,FRAME,TRACE,REFLOW,OUT
NS_HKEY_CURRENT_USER	NS,HKEY,CURRENT,USER
NS_HTTP_STICKY_CONNECTION	NS,HTTP,STICKY,CONNECTION
NS_IMAPSERVICE_CONTRACTID	NS,IMAP,SERVICE,CONTRACT,ID
NS_IROBOTSINK_IID	NS,I,ROBOT,SINK,IID
NS_LOADER_DATA_ALLOC_STEP	NS,LOADER,DATA,ALLOC,STEP
NS_MATHML_PSEUDO_UNIT_LSPACE	NS,MATHML,PSEUDO,UNIT,LSPACE
NS_NET_STATUS_WROTE_TO	NS,NET,STATUS,WROTE,TO
NS_NNTPINCOMINGSERVER_CONTRACTID	NS,NNT,PIN,COMING,SERVER,CONTRACT,ID
NS_NewGenericModule	NS,New,Generic,Module
NS_NewPlaceholderFrame	NS,New,Placeholder,Frame
NS_PRINTINGPROMPTSERVICE_CONTRACTID	NS,PRINTING,PROMPT,SERVICE,CONTRACT,ID
NS_QUICKLAUNCH_RUN_KEY	NS,QUICK,LAUNCH,RUN,KEY
NS_REGRESSION_TESTER_CID	NS,REGRESSION,TESTER,CID
NS_SCHEMAANYPARTICLE_CONTRACTID	NS,SCHEMAANY,PARTICLE,CONTRACT,ID
NS_STYLE_BG_CLIP_PADDING	NS,STYLE,BG,CLIP,PADDING
NS_STYLE_CURSOR_DEFAULT	NS,STYLE,CURSOR,DEFAULT
NS_STYLE_RESIZER_HORIZONTAL	NS,STYLE,RESIZER,HORIZONTAL
NS_STYLE_VERTICAL_ALIGN_MIDDLE	NS,STYLE,VERTICAL,ALIGN,MIDDLE
NS_UNICODETOCP855_CID	NS,UNICODE,TO,CP,855,CID
NS_UNICODETOMACROMAN_CONTRACTID	NS,UNICODE,TO,MACRO,MAN,CONTRACT,ID
NTLMSSP_NEGOTIATE_NTLM	NTLMSSP,NEGOTIATE,NTLM
NT_STATUS_EVENTLOG_FILE_CHANGED	NT,STATUS,EVENT,LOG,FILE,CHANGED
NUMBLOCKPOPS	NUM,BLOCK,POPS
NXKeyDelete	NX,Key,Delete
N_DECL_ALLY	N,DECL,ALLY
N_DOSYNC	N,DO,SYNC
N_EL_FRAME	N,EL,FRAME
NaNIndices.length	Na,NIndices,length
NavElement	Nav,Element
NewContainerDialog_error_enterpath	New,Container,Dialog,error,enter,path
NewEventHandlerUPP	New,Event,Handler,UPP
NewVarRef	New,Var,Ref
NextFocusMatcher	Next,Focus,Matcher
NotifyAllCondVar	Notify,All,Cond,Var
OBJ_SZ_TO_BLOCKS	OBJ,SZ,TO,BLOCKS
OBSBuffer	OBS,Buffer
OFdefIOs	OF,def,IOs
OO7_ComplexAssemblyImpl	OO,7,Complex,Assembly,Impl
OPT_STOP_DATETIME	OPT,STOP,DATETIME
OP_FILEREQANSNOFIL	OP,FILE,REQ,ANS,NO,FIL
OP_TYPEUPTO	OP,TYPE,UP,TO
OS_THREAD_PRIORITY_ABOVE_NORMAL	OS,THREAD,PRIORITY,ABOVE,NORMAL
OS_WAIT_SCAN	OS,WAIT,SCAN
OUTF_W	OUTF,W
OnBnClickedAscwop	On,Bn,Clicked,Ascwop
OnBnClickedClosechat	On,Bn,Clicked,Close,chat
OnChooseAppClicked	On,Choose,App,Clicked
OnEnKillfocusCollectionnameedit	On,En,Kill,focus,Collection,name,edit
OnFileSaveas	On,File,Save,as
OnMsgClose	On,Msg,Close
OnNPPURLNotify	On,NPP,URL,Notify
OnOptionDisabled	On,Option,Disabled
Order.LT	Order,LT
OyoahaEditCell	Oyoaha,Edit,Cell
PAGE_UP	PAGE,UP
PAR_INTEGERKEY	PAR,INTEGER,KEY
PATTERN_CHANGESET	PATTERN,CHANGE,SET
PCS_NOTVERIFIED	PCS,NOT,VERIFIED
PDB_COUNT	PDB,COUNT
PD_RETURNDEFAULT	PD,RETURN,DEFAULT
PH_TO_NS_RGB	PH,TO,NS,RGB
PK11ObjectListElement	PK,11,Object,List,Element
PK11_ALWAYS	PK,11,ALWAYS
PK11_SETATTRS	PK,11,SET,ATTRS
PK11_SetPublicKeyNickname	PK,11,Set,Public,Key,Nickname
PK11_UnwrapPrivKey	PK,11,Unwrap,Priv,Key
PKCS11Constants.CKM_RC5_ECB	PKCS,11,Constants,CKM,RC,5,ECB
PKCS9	PKCS,9
PLUGINS_DIR_NAME	PLUGINS,DIR,NAME
PLUGIN_LOG_NAME	PLUGIN,LOG,NAME
PLUS_OP__START_OFFSET	PLUS,OP,START,OFFSET
PL_strdup	PL,str,dup
PMatrixRenderer	P,Matrix,Renderer
PNG_READ_iTXt_MODE	PNG,READ,i,TXt,MODE
PNG_WRITE_PACK_SUPPORTED	PNG,WRITE,PACK,SUPPORTED
POLYGON_EXCL	POLYGON,EXCL
PRINTER_ACE_FULL_CONTROL	PRINTER,ACE,FULL,CONTROL
PRINTER_ENUM_LOCAL	PRINTER,ENUM,LOCAL
PRI_EVENT_SETUP_ACK	PRI,EVENT,SETUP,ACK
PROPS_FILE_DEF	PROPS,FILE,DEF
PROP_TASK_DESC	PROP,TASK,DESC
PROP_USE_CD_UNITS_DEFAULT	PROP,USE,CD,UNITS,DEFAULT
PRRecvfromFN	PR,Recv,from,FN
PRSeek64FN	PR,Seek,64,FN
PR_CONTACT_DEFAULT_ADDRESS_INDEX	PR,CONTACT,DEFAULT,ADDRESS,INDEX
PR_CallOnce	PR,Call,Once
PR_GetObjectHeader	PR,Get,Object,Header
PR_HOME_ADDRESS_COUNTRY_W	PR,HOME,ADDRESS,COUNTRY,W
PR_INSERT_LINK	PR,INSERT,LINK
PR_REPORT_ENTRYID	PR,REPORT,ENTRY,ID
PR_SENTMAIL_ENTRYID	PR,SENT,MAIL,ENTRY,ID
PSY_ALPHA_VERSION	PSY,ALPHA,VERSION
PS_COMPLETE	PS,COMPLETE
Padarin	Padarin
ParsedXMLContent	Parsed,XML,Content
PdfAnnotPlugin.EDITOR_ID	Pdf,Annot,Plugin,EDITOR,ID
PepsynConstants.SAMPLE_NAME_PARM	Pepsyn,Constants,SAMPLE,NAME,PARM
Ph_CURSOR_QUESTION_POINT	Ph,CURSOR,QUESTION,POINT
Pk11Install_Platform	Pk,11,Install,Platform
PluginVClient	Plugin,V,Client
PolygonDraggingApplet	Polygon,Dragging,Applet
PovReflectionGeneImpl	Pov,Reflection,Gene,Impl
PrefetchHref	Prefetch,Href
ProcessorC	Processor,C
ProjectElement.INCLUDE_BASE_TAG	Project,Element,INCLUDE,BASE,TAG
Project_ID3.chemin_mp3	Project,ID,3,chemin,mp3
Props.BOX_BG_COLOR	Props,BOX,BG,COLOR
Pt_ARG_MOZ_AUTH_CTRL	Pt,ARG,MOZ,AUTH,CTRL
PyDict_GetItemString	Py,Dict,Get,Item,String
PyEval_ReleaseThread	Py,Eval,Release,Thread
PyTypeMethod_str	Py,Type,Method,str
QER_PLUG_VERSION	QER,PLUG,VERSION
QS_BODY	QS,BODY
QUOT_ENTITY	QUOT,ENTITY
QWheelEvent	QWheel,Event
Q_isalpha	Q,is,alpha
QoSDrxAlarmEventReceiverEventHandlerImplShell	Qo,SDrx,Alarm,Event,Receiver,Event,Handler,Impl,Shell
Qt.Key.Key_Up	Qt,Key,Key,Up
QueryField.field_type.alpha_field	Query,Field,field,type,alpha,field
QvtAstPackage.Literals.MULTI_DECLARATOR_VSEP_AST	Qvt,Ast,Package,Literals,MULTI,DECLARATOR,VSEP,AST
RAW_CD_SECTOR_SIZE	RAW,CD,SECTOR,SIZE
RBACResourceTypeEntry	RBAC,Resource,Type,Entry
RCS_lock	RCS,lock
READ_FIFO	READ,FIFO
REFTREES_CHILDREFID	REF,TREES,CHILD,REF,ID
REGENUM_CHILDREN	REG,ENUM,CHILDREN
REGISTEREDBY_AD_Reference_ID	REGISTERED,BY,AD,Reference,ID
RELOAD_MIN_TIME	RELOAD,MIN,TIME
RELOP_LT	RELOP,LT
REPEAT_TYPE_DAILY	REPEAT,TYPE,DAILY
RES0_C	RES,0,C
RID_LOC	RID,LOC
RMIApp	RMI,App
ROCPreferencePage	ROC,Preference,Page
ROT_Y_LEFT	ROT,Y,LEFT
RSS20_WEBMASTER	RSS,20,WEBMASTER
RaistlinServlet	Raistlin,Servlet
ReadCallBackFn	Read,Call,Back,Fn
ReadUtf8Z	Read,Utf,8,Z
Record.PROC_EXEC_FAILURE	Record,PROC,EXEC,FAILURE
RefondeDialogProprietesProjet	Refonde,Dialog,Proprietes,Projet
RegEnumKey	Reg,Enum,Key
RegisterUtf8	Register,Utf,8
RegistryMessages.meta_registryCacheWriteProblems	Registry,Messages,meta,registry,Cache,Write,Problems
ResizeWindowBy	Resize,Window,By
Resources.EXT_PSX	Resources,EXT,PSX
ResponseCodes.OBEX_HTTP_OK	Response,Codes,OBEX,HTTP,OK
Row2Ptr	Row,2,Ptr
RpageIdC	R,page,Id,C
SBS_VERT	SBS,VERT
SCRAMBLED_PASSWORD_CHAR_LENGTH	SCRAMBLED,PASSWORD,CHAR,LENGTH
SCROLLER_HIGHLIGHT	SCROLLER,HIGHLIGHT
SEARCHNOTES_LIFETIME	SEARCH,NOTES,LIFETIME
SECKEYKeyDBHandle	SECKEY,Key,DB,Handle
SECUREOSF	SECURE,OSF
SECURE_RANDOM_ALGO_NAME	SECURE,RANDOM,ALGO,NAME
SECU_PrintUTCTime	SECU,Print,UTC,Time
SEC_DOMAIN	SEC,DOMAIN
SEC_ERROR_PKCS12_INVALID_MAC	SEC,ERROR,PKCS,12,INVALID,MAC
SEC_SignData	SEC,Sign,Data
SET_AND_EXPR	SET,AND,EXPR
SF_FORMAT_SD2	SF,FORMAT,SD,2
SHA_SUCCESS	SHA,SUCCESS
SHOW_SSL_CTX_SESS_ACCEPT	SHOW,SSL,CTX,SESS,ACCEPT
SHOW_SSL_CTX_SESS_HITS	SHOW,SSL,CTX,SESS,HITS
SID_HOWMANY	SID,HOW,MANY
SIGNATURE_VERIFIER_CONTRACTID	SIGNATURE,VERIFIER,CONTRACT,ID
SIMPLE_SCROLL_MODE	SIMPLE,SCROLL,MODE
SITE_NAME_RHO_RB	SITE,NAME,RHO,RB
SITZKRIEG	SITZKRIEG
SMB_GROUP_QUOTA_TYPE	SMB,GROUP,QUOTA,TYPE
SMB_VFS_OP_SYS_ACL_SET_PERMSET	SMB,VFS,OP,SYS,ACL,SET,PERMSET
SMTP_TLS_RESPONSE	SMTP,TLS,RESPONSE
SND_PCM_HW_PARAM_PERIODS	SND,PCM,HW,PARAM,PERIODS
SND_SEQ_EVENT_INSTR_LIST	SND,SEQ,EVENT,INSTR,LIST
SNIFFER_ENTRY	SNIFFER,ENTRY
SOUNDTRACK_WEATHERAMBIENCE	SOUNDTRACK,WEATHER,AMBIENCE
SPL_ARCH_W32ALPHA	SPL,ARCH,W,32,ALPHA
SPOOL_Q_REPLYOPENPRINTER	SPOOL,Q,REPLY,OPEN,PRINTER
SQLCOM_SHOW_PROCESSLIST	SQL,COM,SHOW,PROCESS,LIST
SQLD_BS_SEQS_ID_COL	SQLD,BS,SEQS,ID,COL
SQLExecuteParams	SQL,Execute,Params
SQL_DIRECTORY_ATTR	SQL,DIRECTORY,ATTR
SSL_AIDX_DSA	SSL,AIDX,DSA
SSL_ERROR_RX_MALFORMED_APPLICATION_DATA	SSL,ERROR,RX,MALFORMED,APPLICATION,DATA
SSL_ERROR_RX_UNKNOWN_ALERT	SSL,ERROR,RX,UNKNOWN,ALERT
SSL_set_accept_state	SSL,set,accept,state
STAT2_SL_SUPPRESS	STAT,2,SL,SUPPRESS
STATEMENTEDIT_BUF_SIZE	STATEMENT,EDIT,BUF,SIZE
SUBLANG_ARABIC_EGYPT	SUBLANG,ARABIC,EGYPT
SUNOS5DL	SUNOS,5,DL
SV_AreaEntities_r	SV,Area,Entities,r
SV_ConSay_f	SV,Con,Say,f
SV_RankReportStr	SV,Rank,Report,Str
SWIGScrolledWindowUpcast	SWIG,Scrolled,Window,Upcast
SWTSwingGraphics2DClientProperty	SWTSwing,Graphics,2,DClient,Property
SYSTEM_AGENTS_GROUP_NAME	SYSTEM,AGENTS,GROUP,NAME
S_ISMPB	S,ISMPB
SafepeerConfigConstants.ENABLE_BLOCKLIST_MANAGER	Safe,peer,Config,Constants,ENABLE,BLOCKLIST,MANAGER
SaveDocumentInternal	Save,Document,Internal
Scanner.SYM_EQUAL	Scanner,SYM,EQUAL
SchemeParser.TkUnquoteSplicing	Scheme,Parser,Tk,Unquote,Splicing
ScrollWidgets	Scroll,Widgets
SearchUI.LINE	Search,UI,LINE
SecurityResources.NAMESPACE	Security,Resources,NAMESPACE
ServerConf.SENSE_BODY_STEP	Server,Conf,SENSE,BODY,STEP
ServerConfig.pieceImageFile	Server,Config,piece,Image,File
ServerDoesntSupportACL	Server,Doesnt,Support,ACL
SetLeaveAsAscii	Set,Leave,As,Ascii
SetMaxUpload	Set,Max,Upload
SetMsgHdrCacheSize	Set,Msg,Hdr,Cache,Size
SetUnusedInput	Set,Unused,Input
ShareResourceEvent.ET_ATTRIBUTE_CHANGED	Share,Resource,Event,ET,ATTRIBUTE,CHANGED
SimpleCpcClient::Parser_t::ParserStatus	Simple,Cpc,Client,Parser,t,Parser,Status
Sinavi2TypeEcluse	Sinavi,2,Type,Ecluse
SmtpHeadersInterface.CONTENT_TRANSFER_ENCODING	Smtp,Headers,Interface,CONTENT,TRANSFER,ENCODING
SomeValuesFromRestrictionImpl.factory	Some,Values,From,Restriction,Impl,factory
SourceAttachmentBlock_filename_error_deviceinpath	Source,Attachment,Block,filename,error,device,in,path
Spbox	Sp,box
SprawdzTypySkladnikow	Sprawdz,Typy,Skladnikow
Src.m_lParam	Src,m,l,Param
StandardAlloc	Standard,Alloc
StartServer_MenuInit	Start,Server,Menu,Init
StockingFiltersImpl	Stocking,Filters,Impl
StornoDialog	Storno,Dialog
StrongBinaryEncryptor	Strong,Binary,Encryptor
StyleDisplayImpl	Style,Display,Impl
T1_Block.T1_BLOCK_R_OK	T,1,Block,T,1,BLOCK,R,OK
TAG_FILESIZE	TAG,FILE,SIZE
TAG_NL_VAR	TAG,NL,VAR
TBACKGND	T,BACKGND
TBBTN_TRANSFERS	TB,BTN,TRANSFERS
TCL_RPSTRT_CLIENT	TCL,RPSTRT,CLIENT
TEST_NO_UUID_STRUCT	TEST,NO,UUID,STRUCT
TFNGui.ADD_TRANSITION	TFN,Gui,ADD,TRANSITION
TIMAPMailboxInfo	TI,MAP,Mailbox,Info
TINYSIZE_KEY	TINY,SIZE,KEY
TK_TWIDDLE	TK,TWIDDLE
TMADicotomicIndexedItems	TMA,Dicotomic,Indexed,Items
TME_HOVER	TME,HOVER
TOK_VAR	TOK,VAR
TOPREVFILE	TO,PREV,FILE
TRACEBACK_FETCH_ERROR	TRACEBACK,FETCH,ERROR
TRAinfo	TRA,info
TRG_NUM_REQUIRED_PARAMETERS	TRG,NUM,REQUIRED,PARAMETERS
TRX_SYS_MYSQL_LOG_NAME_LEN	TRX,SYS,MYSQL,LOG,NAME,LEN
TTTONTTIME	TTT,ON,T,TIME
TT_PEEK_LONG	TT,PEEK,LONG
TT_Round_To_Grid	TT,Round,To,Grid
TTdepthage	TT,depth,age
TX_PATTERN_DEBUG	TX,PATTERN,DEBUG
TYPE_CONFIG_TRACK	TYPE,CONFIG,TRACK
TableJSPTag	Table,JSP,Tag
TaggedSeqInSeq.TaggedSeqInSeqSequenceType	Tagged,Seq,In,Seq,Tagged,Seq,In,Seq,Sequence,Type
Tags.CONST	Tags,CONST
TavernaIcons.importUrlIcon	Taverna,Icons,import,Url,Icon
TeamB_correctionButton.addActionListener	Team,B,correction,Button,add,Action,Listener
TemplateConstants.TEMPLATE_VARIABLE_REGEXP	Template,Constants,TEMPLATE,VARIABLE,REGEXP
Terrain_DrawXY	Terrain,Draw,XY
TestTableNonIgnorable	Test,Table,Non,Ignorable
TextStemmer	Text,Stemmer
ThrowCOMError	Throw,COM,Error
TopicRSS	Topic,RSS
TraitSelectorSeqHelper	Trait,Selector,Seq,Helper
TransAction.TYPE_ACTION_CHANGE_JOB_HOP	Trans,Action,TYPE,ACTION,CHANGE,JOB,HOP
TreeNode.NOCHILD	Tree,Node,NO,CHILD
TypeParameter.PARAM_COMMENT	Type,Parameter,PARAM,COMMENT
Types.BIGINT	Types,BIG,INT
UI_LoadArenas	UI,Load,Arenas
UI_POPUP_INFO	UI,POPUP,INFO
UMLMetafacadeProperties.DEFAULT_IDENTIFIER_VISIBILITY	UML,Metafacade,Properties,DEFAULT,IDENTIFIER,VISIBILITY
UNALIGNED_OFFSET_ASM_OP	UNALIGNED,OFFSET,ASM,OP
UNINSTALL_FAILED	UNINSTALL,FAILED
UNI_LEFT_SINGLE_QUOTE	UNI,LEFT,SINGLE,QUOTE
UPD_MM_DEL_ARRAY	UPD,MM,DEL,ARRAY
UPRIGHT_RESIZE	UPRIGHT,RESIZE
USE_FREETYOE	USE,FREE,TYOE
USE_GENERIC	USE,GENERIC
USE_MEMSET	USE,MEM,SET
USE_NC_EXTENSION	USE,NC,EXTENSION
USE_SETREUID	USE,SET,REUID
USTR_SIZE	U,STR,SIZE
UTC_TIMESTAMP_SYM	UTC,TIMESTAMP,SYM
UnRegisterSession	Un,Register,Session
UnfreezeExpressionAction	Unfreeze,Expression,Action
UngroupSelectedArtifactsAdapter.TOOLTIP	Ungroup,Selected,Artifacts,Adapter,TOOLTIP
UnicodeNotFromInputMethodHandler	Unicode,Not,From,Input,Method,Handler
UninstallConduit	Uninstall,Conduit
UnknownJavascriptContentParser	Unknown,Javascript,Content,Parser
UnregisterContentPolicy	Unregister,Content,Policy
UnregisterHotKey	Unregister,Hot,Key
UpdateResFile	Update,Res,File
UserControl	User,Control
UserProperties.APP_RSRC_PREFIX	User,Properties,APP,RSRC,PREFIX
V4L2_CAP_TIMEPERFRAME	V,4,L,2,CAP,TIME,PER,FRAME
VCARD.PRODID	V,CARD,PROD,ID
VCARD_LDAP_IBMMAIL_TYPE	VCARD,LDAP,IBM,MAIL,TYPE
VCCityProp	VC,City,Prop
VCFullNameProp	VC,Full,Name,Prop
VLNEXT	VL,NEXT
ValueAxis.DEFAULT_CROSSHAIR_VISIBLE	Value,Axis,DEFAULT,CROSSHAIR,VISIBLE
VerifyRuntime	Verify,Runtime
VirtualGraphics.bgcolor	Virtual,Graphics,bg,color
VisualCalInterpreter	Visual,Cal,Interpreter
VueImage	Vue,Image
WC_SCROLLBAR_STRING	WC,SCROLLBAR,STRING
WEBSVC_GEN_URLS	WEBSVC,GEN,URLS
WH_DEBUG	WH,DEBUG
WIFSIGNALED	WIF,SIGNALED
WM_SETFOCUS	WM,SET,FOCUS
WSAEMSGSIZE	WSAE,MSG,SIZE
WSA_GRANT_ACCESS_TO_ALL	WSA,GRANT,ACCESS,TO,ALL
WS_CARBON	WS,CARBON
WebServiceLifecycleHandler	Web,Service,Lifecycle,Handler
WijaBehaviorFiler.ATTN_TO_FRONT	Wija,Behavior,Filer,ATTN,TO,FRONT
WindowNoPanel	Window,No,Panel
WorkbenchPlugin.PI_WORKBENCH	Workbench,Plugin,PI,WORKBENCH
WsdlSettings.ALLOW_INCORRECT_CONTENTTYPE	Wsdl,Settings,ALLOW,INCORRECT,CONTENT,TYPE
X509_NAME_cmp	X,509,NAME,cmp
XA_FLAGS	XA,FLAGS
XC_hand2	XC,hand,2
XCreateGC	X,Create,GC
XIMHighlight	XIM,Highlight
XK_KP_Delete	XK,KP,Delete
XK_KP_Subtract	XK,KP,Subtract
XMLConfig.TYPEDEF_LIST_ATTR	XML,Config,TYPEDEF,LIST,ATTR
XMLCyclePrinter	XML,Cycle,Printer
XMLDocumentClipboard	XML,Document,Clipboard
XMLFileHandlerTest	XML,File,Handler,Test
XPC_Log_Finish	XPC,Log,Finish
XPT_NewXDRState	XPT,New,XDR,State
XP_PlatformFileToURL	XP,Platform,File,To,URL
XPathReferenceFinderTest	XPath,Reference,Finder,Test
XShmCreateImage	XShm,Create,Image
XVID_KEYFRAME	XVID,KEYFRAME
XVID_ME_QUARTERPELREFINE8_RD	XVID,ME,QUARTER,PEL,REFINE,8,RD
XlaCtr	Xla,Ctr
XmlEntityLibrary.INCLUDES_VALUE_TAG	Xml,Entity,Library,INCLUDES,VALUE,TAG
XpuGetResolution	Xpu,Get,Resolution
XtMoveWidget	Xt,Move,Widget
XtNminWidth	Xt,Nmin,Width
Y4M_ERR_BADEOF	Y,4,M,ERR,BADEOF
YNormalized	Y,Normalized
ZFULL_FRAGRECORD_ERROR	Z,FULL,FRAG,RECORD,ERROR
ZT_DIAL	ZT,DIAL
ZZLogger	ZZ,Logger
ZimbraNamespace.ZIMBRA	Zimbra,Namespace,ZIMBRA
_AFX_CMDTARGET_GETSTATE	AFX,CMD,TARGET,GET,STATE
_BDF_DWIDTH	BDF,D,WIDTH
_F_INOUT	F,IN,OUT
_IO_peekc	IO,peek,c
_MORKCONFIG_	MORK,CONFIG
_Mult_Inner_Loop	Mult,Inner,Loop
_PR_HAVE_LARGE_OFF_T	PR,HAVE,LARGE,OFF,T
_PR_MD_MEM_UNMAP	PR,MD,MEM,UNMAP
_PR_MD_OPEN_FILE	PR,MD,OPEN,FILE
_PT_PTHREAD_MUTEX_IS_LOCKED	PT,PTHREAD,MUTEX,IS,LOCKED
__db_db_truncate_4001_svc	db,db,truncate,4001,svc
__db_refresh	db,refresh
__db_vrfy_freelist	db,vrfy,free,list
__dbreg_init_print	dbreg,init,print
__doadv	do,adv
__ham_add_dup	ham,add,dup
__ham_onpage_replace	ham,onpage,replace
__mpool_get	mpool,get
__os_segdata_find_byname	os,seg,data,find,by,name
__rw_exception	rw,exception
__txn_prepare_proc	txn,prepare,proc
_af_default_double_pcm_mapping	af,default,double,pcm,mapping
_att_lm	att,lm
_get_dpa	get,dpa
_gridComponents	grid,Components
_gsl_vector_float_view_array_with_stride_	gsl,vector,float,view,array,with,stride
_httpProtocolVersion	http,Protocol,Version
_maxWallTime	max,Wall,Time
_pointBorderColour.setSelectedIndex	point,Border,Colour,set,Selected,Index
_pr_solx86_clock_gettime	pr,solx,86,clock,get,time
_rc_param_	rc,param
_snd_pcm_scope_level	snd,pcm,scope,level
_strSearchTree	str,Search,Tree
_tunes.behavior.isITunesEnabled	tunes,behavior,is,ITunes,Enabled
a.ecart_	a,ecart
aAccValue	a,Acc,Value
aAttrChangeArg	a,Attr,Change,Arg
aCallback	a,Call,back
aCfhtml	a,Cf,html
aConfGold	a,Conf,Gold
aConstructorCID	a,Constructor,CID
aDesiredWidgetSize.width	a,Desired,Widget,Size,width
aDidCompile	a,Did,Compile
aFrameNum	a,Frame,Num
aIPCCard	a,IPC,Card
aLLCurve	a,LL,Curve
aMinVerticalPos	a,Min,Vertical,Pos
aModRemoteRecList	a,Mod,Remote,Rec,List
aMoreEncodings	a,More,Encodings
aNumPagesX	a,Num,Pages,X
aP3PHeader	a,P,3,P,Header
aRGBMap	a,RGB,Map
aReadere	a,Reader,e
aReflowState.footerFrame	a,Reflow,State,footer,Frame
aRowEndY	a,Row,End,Y
aSLSpan	a,SL,Span
aSVG.mStrokeOpacity	a,SVG,m,Stroke,Opacity
aScrollTopLeft	a,Scroll,Top,Left
aStateId	a,State,Id
aTransferables	a,Transferables
aUsesOCSP	a,Uses,OCSP
aXMLTerminal	a,XML,Terminal
a_explanation	a,explanation
aassettings.phys_watergravity	aas,settings,phys,water,gravity
absII	abs,II
ac3_bit_allocation.dbknee	ac,3,bit,allocation,db,knee
accParent	acc,Parent
actionPluginIds	action,Plugin,Ids
actual_type	actual,type
addActionSet	add,Action,Set
addBpelProcessUrl	add,Bpel,Process,Url
addDocFVsToFile	add,Doc,FVs,To,File
addLibfileset	add,Lib,file,set
addResumeOperation	add,Resume,Operation
addToEulaClassPath	add,To,Eula,Class,Path
addUsersToRol	add,Users,To,Rol
addWall	add,Wall
add_addr	add,addr
add_decroche	add,decroche
add_new_elt	add,new,elt
addrBook	addr,Book
addrncase	addr,n,case
adds	adds
adpcm_encode_init	ad,pcm,encode,init
ads_sid_to_name	ads,sid,to,name
affine_rank	affine,rank
agd_serv_struct.fkt	agd,serv,struct,fkt
agentrulewrapper.resultingEvents	agent,rule,wrapper,resulting,Events
aibw	ai,bw
aichtag	aichtag
ainfo_class_initialized	a,info,class,initialized
ajp_msg_append_string_ex	ajp,msg,append,string,ex
alertBiz	alert,Biz
alloc_EXPR_LIST	alloc,EXPR,LIST
allows_mem	allows,mem
alsa_lisp_t	alsa,lisp,t
anSsrc	an,Ssrc
ap_cpystrn	ap,cpy,strn
apacheStopBFE	apache,Stop,BFE
apath.inner_box	a,path,inner,box
apiScanRec	api,Scan,Rec
appParam	app,Param
appSchemas	app,Schemas
applyFormChanges	apply,Form,Changes
approxlib_ml	approx,lib,ml
apr_fcvt	apr,fcvt
argSwigKeyboardEvent	arg,Swig,Keyboard,Event
arg_blockname2	arg,block,name,2
argind	arg,in,d
arglex_token_update_not	arg,lex,token,update,not
args	args
argsbuffer	args,buffer
art_pixbuf_free_shallow	art,pix,buf,free,shallow
ase.buffer	ase,buffer
asm_high_label	asm,high,label
ast_dsp_get_tcount	ast,dsp,get,tcount
ast_rtp_lookup_code	ast,rtp,lookup,code
ast_say_datetime	ast,say,date,time
atk_state_set_add_state	atk,state,set,add,state
attConfigs	att,Configs
attr.win_gravity	attr,win,gravity
attractorCount	attractor,Count
attrsExp	attrs,Exp
audio_ch	audio,ch
audio_strerror	audio,str,error
authFinished	auth,Finished
authnokey	auth,no,key
authorityLen	authority,Len
autohelper_func	auto,helper,func
avWeightDiff	av,Weight,Diff
avg_pixels8_iwmmxt	avg,pixels,8,iwmmxt
aviSynthPanel	avi,Synth,Panel
axc	axc
b.m_inline	b,m,inline
b.m_partsize	b,m,part,size
bAlphaIsValid	b,Alpha,Is,Valid
bGotCurrentCharsetSource	b,Got,Current,Charset,Source
backfill_outside_liberty.pos	backfill,outside,liberty,pos
bagViewCount	bag,View,Count
base_init_list	base,init,list
base_source_filenames	base,source,filenames
bb_reg_last_clobbers	bb,reg,last,clobbers
bcBitCount	bc,Bit,Count
bcopyall	b,copy,all
bctu	b,ct,u
begin_compound_stmt	begin,compound,stmt
bestbm.descent	best,bm,descent
bestdot	best,dot
beyond_eor	beyond,eor
bgMeans	bg,Means
bg_mapper_matrix	bg,mapper,matrix
bglight	bg,light
biYPelsPerMeter	bi,YPels,Per,Meter
bindingUri	binding,Uri
bisexec_environment	bis,exec,environment
bitmap_choice_mult_item	bitmap,choice,mult,item
bitsx	bitsx
blindCopy	blind,Copy
blkn	blkn
bmInfo.bmHeight	bm,Info,bm,Height
bmwidth	bm,width
body.cons.numSubs	body,cons,num,Subs
bodyContent	body,Content
bodyname	body,name
bpFirstBase	bp,First,Base
branch_gt	branch,gt
bs_write_ue	bs,write,ue
btnSignActionPerformed	btn,Sign,Action,Performed
bulletinUid	bulletin,U,id
buttonEl	button,El
byCFGB	by,CFGB
c.ll_corner	c,ll,corner
c4x_int_reglist	c,4,x,int,reg,list
c_pointcontents	c,point,contents
cachePtr	cache,Ptr
calcHeight	calc,Height
calcmandfpasmstart	calc,m,and,fp,asm,start
call_rtx	call,rtx
callingpres	calling,pres
callsite	call,site
campspot_t	camp,spot,t
canEditAsUserAdmin	can,Edit,As,User,Admin
cart.ship_info.ship_method	cart,ship,info,ship,method
caseTNewline	case,T,Newline
catalogdownload	catalog,download
catback	cat,back
cattrinbufFileSize	c,attr,in,buf,File,Size
cblen	cb,len
cbuf.data	c,buf,data
cbxMetamodel	cbx,Meta,model
ccanvas_y	ccanvas,y
cchMatchingPath	cch,Matching,Path
ce1_div	ce,1,div
celtype	cel,type
certcount	cert,count
cf_2d_decode	cf,2,d,decode
cfirstfreelcpConnect	c,first,free,lcp,Connect
cfont_dict_keys	c,font,dict,keys
cg_pmove.gauntletHit	cg,p,move,gauntlet,Hit
cgm_clip_indicator	cgm,clip,indicator
cgs.media.redScoredSound	cgs,media,red,Scored,Sound
chain_alloced	chain,alloced
channelmodify	channel,modify
charbuff	char,buff
charstring_execchar	char,string,exec,char
checkIfAllBound	check,If,All,Bound
checkStartThread	check,Start,Thread
check_hosts_equiv	check,hosts,equiv
chk2modws	chk,2,modws
chk_status	chk,status
choice_syrecos	choice,syrecos
chpw_req.data	chpw,req,data
chroma.blue.x	chroma,blue,x
ci.mContractID	ci,m,Contract,ID
ci_collection_end	ci,collection,end
cipbp.dirInfo.ioFlAttrib	cipbp,dir,Info,io,Fl,Attrib
cl.timeoutcount	cl,timeout,count
classEntryTmpl.className	class,Entry,Tmpl,class,Name
clblPageCounter	clbl,Page,Counter
clcpConnectsize	clcp,Connect,size
cleanup_elt	cleanup,elt
clearDependentData	clear,Dependent,Data
clearInputLine	clear,Input,Line
cli_add_queue_member	cli,add,queue,member
cli_set_user_quota	cli,set,user,quota
cli_show_locals	cli,show,locals
client_procs.copy_for	client,procs,copy,for
clienthandler	client,handler
clipWidget	clip,Widget
clone._comparators	clone,comparators
cloneChoice	clone,Choice
cm_xorot	cm,xorot
cmap_fields	cmap,fields
cmdZoomOut_mouseReleased	cmd,Zoom,Out,mouse,Released
cmd_PrefillForm	cmd,Prefill,Form
cmd_op_fill_rect_short	cmd,op,fill,rect,short
cmd_stop	cmd,stop
cmmfCertificate	cmmf,Certificate
cmmf_CertOrEncCertSetCertificate	cmmf,Cert,Or,Enc,Cert,Set,Certificate
cmmf_decode_process_cert_response	cmmf,decode,process,cert,response
cmodel_calculate_max	c,model,calculate,max
coercedDesc	coerced,Desc
col.m_chs	col,m,chs
col3.green	col,3,green
colorBoldCyan	color,Bold,Cyan
com.adaptiveplanning.system.SystemConfig	com,adaptive,planning,system,System,Config
com.agical.rmock.core.expectation.modification.MultiplicityModifier	com,agical,rmock,core,expectation,modification,Multiplicity,Modifier
com.apelon.dts.client.namespace.Namespace	com,apelon,dts,client,namespace,Namespace
com.capgemini.mda.model.Visitor	com,cap,gemini,mda,model,Visitor
com.corendal.netapps.framework.workflow.writedatafactories.ProcessExecutionDateFactory	com,corendal,net,apps,framework,workflow,write,data,factories,Process,Execution,Date,Factory
com.esiglo.framework.core.apploader.security.jaxb.SecurityAuthorization	com,esiglo,framework,core,apploader,security,jaxb,Security,Authorization
com.eviware.soapui.impl.wsdl.panels.request.components.editor.XmlDocument	com,eviware,soapui,impl,wsdl,panels,request,components,editor,Xml,Document
com.flexstor.ejb.sql.application_t	com,flexstor,ejb,sql,application,t
com.greendiamond.rivernorth.ui.SelectionListener	com,green,diamond,river,north,ui,Selection,Listener
com.gridsystems.module.api.ApiRegisteredType	com,grid,systems,module,api,Api,Registered,Type
com.hp.hpl.jena.sparql.engine.iterator.QueryIterBlockTriples	com,hp,hpl,jena,sparql,engine,iterator,Query,Iter,Block,Triples
com.ibm.richtext.print	com,ibm,rich,text,print
com.icodeon.services.cmi.InteractionType	com,icodeon,services,cmi,Interaction,Type
com.icodeon.services.cmi.Step	com,icode,on,services,cmi,Step
com.kbquest.util.resource.DisposalQueueHandler	com,kbquest,util,resource,Disposal,Queue,Handler
com.kopiright.bytecode.classfile.Member	com,kopiright,bytecode,classfile,Member
com.l2fprod.gui.nativeskin.x11	com,l,2,f,prod,gui,native,skin,x,11
com.lgsoft.sendtrap.model.ListDestinationContainer	com,lgsoft,sendtrap,model,List,Destination,Container
com.oy.shared.lw.snmp.IValueSource	com,oy,shared,lw,snmp,I,Value,Source
com.player.posY	com,player,pos,Y
com.pnehrer.mugs.textclient	com,pnehrer,mugs,text,client
com.poeticastudios.general.utilities.array	com,poetica,studios,general,utilities,array
com.projity.pm.scheduling.SchedulingRule	com,projity,pm,scheduling,Scheduling,Rule
com.projity.pm.snapshot.SnapshottableImpl	com,projity,pm,snapshot,Snapshot,table,Impl
com.sri.chemsense.note.SimpleHTMLEditor	com,sri,chem,sense,note,Simple,HTML,Editor
com.sun.rave.web.ui.component.Label	com,sun,rave,web,ui,component,Label
com.sun.rave.web.ui.component.TableRowGroup	com,sun,rave,web,ui,component,Table,Row,Group
com.sun.star.i18n.KParseTokens	com,sun,star,i,18,n,K,Parse,Tokens
com.sun.tools.internal.ws.util	com,sun,tools,internal,ws,util
com.sun.tools.javac.main.JavacOption.HiddenOption	com,sun,tools,javac,main,Javac,Option,Hidden,Option
com.sun.xml.internal.bind.v2.schemagen.xmlschema.LocalAttribute	com,sun,xml,internal,bind,v,2,schema,gen,xml,schema,Local,Attribute
com.thinkingcap.Domains.Install.Exes.CreateDeploymentsGoal	com,thinkingcap,Domains,Install,Exes,Create,Deployments,Goal
com.wm.povclipse.property.megapovxrs.ServerTab	com,wm,povclipse,property,megapovxrs,Server,Tab
com.xerox.VTM.engine.LongPoint	com,xerox,VTM,engine,Long,Point
commentBooleans	comment,Booleans
common_header_len	common,header,len
compNameBytes.length	comp,Name,Bytes,length
compService	comp,Service
comp_inodes	comp,inodes
compare_e_decimal	compare,e,decimal
completeDropTrigger	complete,Drop,Trigger
compress_init	compress,init
computeBreakpointAdornmentFlags	compute,Breakpoint,Adornment,Flags
computedMinHeight	computed,Min,Height
conf.lists.indexed	conf,lists,indexed
config.yellow	config,yellow
configuration.overview	configuration,overview
conn_options.secmode	conn,options,secmode
connectPtr	connect,Ptr
connectpath	connect,path
const_chars	const,chars
constraintsLblIntersection.ipadx	constraints,Lbl,Intersection,ipadx
consumeUnmappedDatastoreField	consume,Unmapped,Datastore,Field
cont.isSelected	cont,is,Selected
containerinfo	container,info
contextSupport.createManagedCollection	context,Support,create,Managed,Collection
contractidString	contract,id,String
control.option.debug_trace_stack_change	control,option,debug,trace,stack,change
convertOB	convert,OB
coordpnt.y	coord,pnt,y
coperturaTot	copertura,Tot
coprFilename	copr,Filename
corrigeAngles	corrige,Angles
cors	cors
cos_lat_M_cos_lon	cos,lat,M,cos,lon
cp_Exporters.getElement	cp,Exporters,get,Element
cp_warning_at	cp,warning,at
cpageFileSize	c,page,File,Size
createChargeLabel	create,Charge,Label
createCsv	create,Csv
createFDC	create,FDC
createHistoryFeedPlugin	create,History,Feed,Plugin
createJMSAdapter	create,JMS,Adapter
createResourceHandler	create,Resource,Handler
createVerCurso16	create,Ver,Curso,16
create_func_char_length	create,func,char,length
create_java_vm_impl	create,java,vm,impl
crlfHeaders	crlf,Headers
crmf_create_prtime	crmf,create,prtime
cryptoMech	crypto,Mech
crypto_flags	crypto,flags
csSEI.fMask	cs,SEI,f,Mask
cs_file_sec	cs,file,sec
cserver	c,server
csvp	csvp
ctimebar_h	ctimebar,h
ctop	ctop
curBlockQuoteIsIndentedWithCSS	cur,Block,Quote,Is,Indented,With,CSS
curHdr	cur,Hdr
cur_client.reg.isreg	cur,client,reg,is,reg
currentAppPosition.y	current,App,Position,y
currentCtx	current,Ctx
curval	cur,val
customLayoutParameter.pageNumber	custom,Layout,Parameter,page,Number
cv_as_string	cv,as,string
cvh	cvh
cz.hdf.gui.HProgressRunnable	cz,hdf,gui,H,Progress,Runnable
d2bd_read	d,2,bd,read
dDelayed	d,Delayed
dInf.widthMember	d,Inf,width,Member
d_rcode	d,rcode
da_str_cut_suffix	da,str,cut,suffix
dat.length	dat,length
databufptr	data,buf,ptr
dayLengthLabel	day,Length,Label
dayOfWeekOf1st	day,Of,Week,Of,1st
dbArray	db,Array
dbObj.ward_id	db,Obj,ward,id
dbRowID	db,Row,ID
dbc_ctp	dbc,ctp
dbt	dbt
dc1394_start_iso_transmission	dc,1394,start,iso,transmission
dcA_Partner	dc,A,Partner
de.anomic.tools.dirlistComparator	de,anomic,tools,dir,list,Comparator
deGappedConsensus	de,Gapped,Consensus
deadsec	dead,sec
dec.signature_	dec,signature
declLambda	decl,Lambda
decode_mcu_AC_first	decode,mcu,AC,first
defarcangpnt	def,arc,ang,pnt
defaultScheduler	default,Scheduler
default_db_port	default,db,port
defender.att	defender,att
definedRegionType	defined,Region,Type
delWalk	del,Walk
del_l	del,l
del_visible_faces	del,visible,faces
deleteUbication	delete,Ubication
deploySbb	deploy,Sbb
descAttr	desc,Attr
descriptorEntityLookup.setDescriptorRuntime	descriptor,Entity,Lookup,set,Descriptor,Runtime
desktopFilms	desktop,Films
dev_proc_fill_mask	dev,proc,fill,mask
device_prefs	device,prefs
dfield_copy_data	d,field,copy,data
dftProps	dft,Props
di.pDatatype	di,p,Data,type
dialogMsg	dialog,Msg
dialog_cb	dialog,cb
dictname	dict,name
dij	dij
dir2_errno	dir,2,errno
dirPropCount	dir,Prop,Count
dirYoffset	dir,Y,offset
dir_ref	dir,ref
direct_frame_copy	direct,frame,copy
directoryUrl	directory,Url
dirst	dir,st
displayOptionsInfo.brightness.maxvalue	display,Options,Info,brightness,max,value
div_r	div,r
dladdr	dl,addr
dll_eth_get_work	dll,eth,get,work
doCarteCharacters	do,Carte,Characters
do_jump_for_compare	do,jump,for,compare
do_layer3_sideinfo	do,layer,3,side,info
do_list_fn	do,list,fn
do_loan	do,loan
do_unlink	do,unlink
document_bar_fg	document,bar,fg
dollar_in_ident	dollar,in,ident
domain_obj	domain,obj
domss	domss
dop.pdriv	dop,pdriv
dosrcs	dosrcs
double_min	double,min
dp8390_stop	dp,8390,stop
dp_conf_t	dp,conf,t
dpre	dpre
dragAddNode.drawy	drag,Add,Node,draw,y
dragitem.fsSupportedOps	drag,item,fs,Supported,Ops
drawMst	draw,Mst
drawTimeBox	draw,Time,Box
drift_comp	drift,comp
dsc_orientation	dsc,orientation
dsortf	d,sort,f
dst0.x	dst,0,x
dst_buffer_to_hmac_md5	dst,buffer,to,hmac,md,5
dtor.token	dtor,token
dtstart.year	dt,start,year
dtype_form_prtype	d,type,form,pr,type
dumpSessionToDTL	dump,Session,To,DTL
durations	durations
dv_init_dct248	dv,init,dct,248
dv_video_source	dv,video,source
dwSourceSampleRate	dw,Source,Sample,Rate
dwUpperLimit	dw,Upper,Limit
dwUser	dw,User
dw_mode	dw,mode
dwarf2out_return_reg	dwarf,2,out,return,reg
dwl	dwl
dzmap_ptr	dz,map,ptr
e.accum	e,accum
e.cdelta	e,cdelta
e.pspeed	e,p,speed
eCSSKeyword__moz_grid_group	e,CSS,Keyword,moz,grid,group
eCSSKeyword_scrollbartrack_vertical	e,CSS,Keyword,scrollbar,track,vertical
eICString_LDAPSearchbase	e,IC,String,LDAP,Searchbase
eLinkState_Unvisited	e,Link,State,Unvisited
eOnDataAvail	e,On,Data,Avail
eSendBehindFront	e,Send,Behind,Front
eStyleStruct_Max	e,Style,Struct,Max
eSystemFont_Tooltips	e,System,Font,Tooltips
e__SystemEnumStrict_n_from_then_to_uts	e,System,Enum,Strict,n,from,then,to,uts
ectr	ectr
edu.colorado.phet.energyskatepark.view.piccolo.SkaterNode	edu,colorado,phet,energy,skate,park,view,piccolo,Skater,Node
edu.mit.wi.omnigene.framework.jaxb.das.gff.SEGMENT	edu,mit,wi,omni,gene,framework,jaxb,das,gff,SEGMENT
eh_proto	eh,proto
elevres	elev,res
emb_read_rows	emb,read,rows
emit_base_init	emit,base,init
encodeDiv	encode,Div
encodeXMLWideFieldElement	encode,XML,Wide,Field,Element
encstr	enc,str
endXMLDocument	end,XML,Document
endtravelflags	end,travel,flags
engine.gameIsDoubleBuffered	engine,game,Is,Double,Buffered
entry.ty_init	entry,ty,init
entry_ptr	entry,ptr
env.width	env,width
eod	eod
ep_mincache_sz	ep,min,cache,sz
eq_func	eq,func
equivs_.last	equivs,last
errFileOpen	err,File,Open
errobj	err,obj
error2ECD	error,2,ECD
errorWarning.filename	error,Warning,filename
error_mark_node	error,mark,node
errstr	err,str
escapedUTF8Spec	escaped,UTF,8,Spec
etm.tm_hour	etm,tm,hour
evTimeRW	ev,Time,RW
event_buf.y	event,buf,y
ex_coeff_d	ex,coeff,d
exact_sos_count	exact,sos,count
examples.jaxb	examples,jaxb
execCM_ADD	exec,CM,ADD
execDICTSTARTCONF	exec,DICT,START,CONF
execDI_FCOUNTCONF	exec,DI,F,COUNT,CONF
execTUP_ALLOCREQ	exec,TUP,ALLOC,REQ
execWAIT_DROP_TAB_REQ	exec,WAIT,DROP,TAB,REQ
execWAIT_GCP_REF	exec,WAIT,GCP,REF
execute_ln	execute,ln
existingNode	existing,Node
exp.tm_hour	exp,tm,hour
explodedDisplay	exploded,Display
expn	expn
exportPHYLIPINTERFile	export,PHYLIPINTER,File
extractClientEntriesFromUrl	extract,Client,Entries,From,Url
extralines	extra,lines
f1.csize	f1,csize
fThreadSendMgr	f,Thread,Send,Mgr
f__curunit	f,cur,unit
f_bkpt	f,bkpt
fartherin	farther,in
fastmin	fast,min
faviconGeneratorElement	favicon,Generator,Element
fbuffer	f,buffer
fc.privateContext	fc,private,Context
fcheckData.data	f,check,Data,data
fdlMeta.left	fdl,Meta,left
fdset	fd,set
ff_mpeg1_find_frame_end	ff,mpeg,1,find,frame,end
ff_vp3_idct_add_mmx	ff,vp,3,idct,add,mmx
ffebld_constant_realdefault	ffe,bld,constant,real,default
ffeexprOperator_	ffe,expr,Operator
ffeexpr_nil_percent_name_	ffe,expr,nil,percent,name
ffeinfo	ffe,info
ffestp_file.type	ffestp,file,type
ffetarget_offset_add	ffe,target,offset,add
fftw_sem_post	fftw,sem,post
field_idx	field,idx
fieldf_mc	field,f,mc
fileNum	file,Num
file_sound_png	file,sound,png
filefield	file,field
filesort_limit	file,sort,limit
fill_params	fill,params
findHostHealths	find,Host,Healths
findSplitRTleaf	find,Split,RT,leaf
finish_for_cond	finish,for,cond
fireGeobjectAnimationChanged	fire,Ge,object,Animation,Changed
firstTuplesFinalDiscPos	first,Tuples,Final,Disc,Pos
first_resize_height	first,resize,height
fix_max_connections	fix,max,connections
fixext	fix,ext
fixshort	fix,short
flFlags	fl,Flags
flag_debug_asm	flag,debug,asm
flag_schedule_insns	flag,schedule,in,sns
flags.address	flags,address
fname.chars	f,name,chars
followup_delta	follow,up,delta
fontAFM	font,AFM
fontColorLU	font,Color,LU
fontset_click	font,set,click
forceUnixStyle	force,Unix,Style
format.mSystemId	format,m,System,Id
formatPos	format,Pos
formatVFSUri	format,VFS,Uri
foundDirID	found,Dir,ID
fpMediaInfo4_Info_Version	fp,Media,Info,4,Info,Version
fp_delete	fp,delete
fpmp	fpmp
fqFromUrl.equals	fq,From,Url,equals
fr.tm.elibel.smartqvt.qvt.imperativeocl.ImperativeExpression	fr,tm,elibel,smart,qvt,qvt,imperative,ocl,Imperative,Expression
frame_num_offset	frame,num,offset
free_debug_proc	free,debug,proc
fromPrecursorProtein	from,Precursor,Protein
fsControl	fs,Control
ft_cleanup_stack_done	ft,cleanup,stack,done
ftpAdapter	ftp,Adapter
fuUsage	fu,Usage
fullurlC	full,url,C
func_items	func,items
g640x480x16_regs	g,640,x,480,x,16,regs
gCatInfoPB.hFileInfo.ioFlXFndrInfo	g,Cat,Info,PB,h,File,Info,io,Fl,XFndr,Info
gConstNoneCharSetMap	g,Const,None,Char,Set,Map
gOverlay.the_gui	g,Overlay,the,gui
gRootAtkObject	g,Root,Atk,Object
gSimpleDOMNodes	g,Simple,DOM,Nodes
gU2Ntable	g,U,2,N,table
g_EUCTWShiftTableSet	g,EUCTW,Shift,Table,Set
g_MacTurkishMappingTable	g,Mac,Turkish,Mapping,Table
g_cond_broadcast	g,cond,broadcast
g_date_update_dmy	g,date,update,dmy
g_nVecVariableCount	g,n,Vec,Variable,Count
g_node_new	g,node,new
g_qeglobals.d_terrainNoiseType	g,qe,globals,d,terrain,Noise,Type
g_return_if_fail	g,return,if,fail
g_ufCP949NoKSCHangulMapping	g,uf,CP,949,No,KSC,Hangul,Mapping
g_weaponRespawn.integer	g,weapon,Respawn,integer
ga_dont_ignore_systab_0	ga,dont,ignore,sys,tab,0
gcLocksHash	gc,Locks,Hash
gdev_prn_size_buf_planar	gdev,prn,size,buf,planar
gdk_draw_image	gdk,draw,image
gdk_pixmap_create_from_xpm	gdk,pix,map,create,from,xpm
gdk_x11_atom_to_xatom	gdk,x,11,atom,to,xatom
ge.col_fuzzy	ge,col,fuzzy
gen_nonce_hash	gen,nonce,hash
gencache_iterate	gen,cache,iterate
generateFrameFile	generate,Frame,File
generateShadowsToXML	generate,Shadows,To,XML
getAllByName	get,All,By,Name
getAssociatedJoinDeclares	get,Associated,Join,Declares
getBaselineDuration	get,Baseline,Duration
getBusinessPClassDC	get,Business,PClass,DC
getClientIdByClientName	get,Client,Id,By,Client,Name
getConfigurationDao	get,Configuration,Dao
getConfigurationDir	get,Configuration,Dir
getCopyCheckbox	get,Copy,Checkbox
getDoubleObjectArray	get,Double,Object,Array
getEOLMarkers	get,EOL,Markers
getElvisRenderer	get,Elvis,Renderer
getEn_db_id	get,En,db,id
getExtClassLoader	get,Ext,Class,Loader
getGLJournalID	get,GL,Journal,ID
getHostnameInitialDefaultValue	get,Hostname,Initial,Default,Value
getIdxElt	get,Idx,Elt
getImageFromPlugin	get,Image,From,Plugin
getInternalDTDSubset	get,Internal,DTD,Subset
getInvKindName	get,Inv,Kind,Name
getKindOfStockTransactionDC	get,Kind,Of,Stock,Transaction,DC
getLastAdmInDateGregorian	get,Last,Adm,In,Date,Gregorian
getLastNumReturnValues	get,Last,Num,Return,Values
getLastViewedSys	get,Last,Viewed,Sys
getMBMessageService	get,MB,Message,Service
getMSEntity	get,MS,Entity
getMaxIn	get,Max,In
getMaxNonceAge	get,Max,Nonce,Age
getNSMapping	get,NS,Mapping
getNativeUnicodeStream	get,Native,Unicode,Stream
getNumeroFils	get,Numero,Fils
getObsXCoord	get,Obs,X,Coord
getOfBOM	get,Of,BOM
getPHPProjects	get,PHP,Projects
getPrefString	get,Pref,String
getServerSystemMode	get,Server,System,Mode
getSingleUserApi	get,Single,User,Api
getStdInName	get,Std,In,Name
getTblOverlap	get,Tbl,Overlap
getThesTerm	get,Thes,Term
getTimersAsXml	get,Timers,As,Xml
getUIRenderer	get,UI,Renderer
getVersionservidor	get,Version,servidor
getViolatedConstraints	get,Violated,Constraints
get_PESOutputEnabled	get,PES,Output,Enabled
get__newEnum	get,new,Enum
get_address_cblas_chpmv	get,address,cblas,chpmv
get_address_gsl_matrix_long_double_max_index	get,address,gsl,matrix,long,double,max,index
get_callerid_ast	get,caller,id,ast
get_log_file	get,log,file
get_mgmd_nodeid	get,mgmd,node,id
get_shm_id	get,shm,id
get_toc	get,toc
get_tsd	get,tsd
getcmpDeploymentDescriptor	get,cmp,Deployment,Descriptor
getcolor	get,color
getservbyname	get,serv,by,name
getterAtom	getter,Atom
glEvalCoord1f	gl,Eval,Coord,1,f
gmlltmp	gmll,tmp
gnu.bonobo.StorageHelper.write	gnu,bonobo,Storage,Helper,write
gov.usda.gdpc.GenotypeExperimentProperty	gov,usda,gdpc,Genotype,Experiment,Property
gpsDownloadWaypointsMenu	gps,Download,Waypoints,Menu
gram_vsa	gram,vsa
greenRGB	green,RGB
grid.xaxis.circular.hmt	grid,x,axis,circular,hmt
gridBagConstraintsX.gridx	grid,Bag,Constraints,X,gridx
groupEntResTypeHasBeenSet	group,Ent,Res,Type,Has,Been,Set
group_concat_key_cmp_with_distinct_and_order	group,concat,key,cmp,with,distinct,and,order
gs_malloc	gs,malloc
gs_setcolortransfer_remap	gs,set,color,transfer,remap
gsl_sf_lambert_Wm1	gsl,sf,lambert,Wm,1
gtk_moz_embed_open_stream	gtk,moz,embed,open,stream
gtk_mozarea_get_toplevel_focus	gtk,mozarea,get,toplevel,focus
gtk_widget_ensure_style	gtk,widget,ensure,style
gtk_widget_hide	gtk,widget,hide
gx_remap_concrete_gray	gx,remap,concrete,gray
gz_compress_mmap	gz,compress,mmap
h263_chroma_roundtab	h,263,chroma,round,tab
h2v2_downsample	h,2,v,2,down,sample
hPB.accessParam.ioVRefNum	h,PB,access,Param,io,VRef,Num
hSel	h,Sel
hWndCombo	h,Wnd,Combo
handle_channelstatus	handle,channel,status
hangup.useruserinfo	hangup,user,user,info
has_lb	has,lb
have_ext	have,ext
hbit	h,bit
hcurr	h,curr
hdr_resp.alloc_hint	hdr,resp,alloc,hint
hdrlen	hdrlen
headExp	head,Exp
help_dimu	help,dimu
hiddenXMax	hidden,X,Max
highestX	highest,X
hisip	his,ip
hit.linkcount	hit,link,count
hlib	h,lib
hookGraphicalViewer	hook,Graphical,Viewer
horzVis	horz,Vis
hostTcBlockRef	host,Tc,Block,Ref
hpb.ioDirID	hpb,io,Dir,ID
hpcxs	hpcxs
htdbm_init	htdbm,init
html40Latin1	html,40,Latin,1
hval	h,val
hwndCancel	hwnd,Cancel
i.lvals	i,l,vals
iCCP_TYPE	i,CCP,TYPE
iMin	i,Min
iTermcond	i,Term,cond
i_qp0_cost2_table	i,qp,0,cost,2,table
iaaa.application.Application	iaaa,application,Application
icallangbind_get_first_property	icallangbind,get,first,property
icause	i,cause
icmLuMonoFwd_map	icm,Lu,Mono,Fwd,map
icmTextDescription_get_size	icm,Text,Description,get,size
iconLense	icon,Lense
iconv_close	i,conv,close
id_clash_len	id,clash,len
idct_cosine_table	id,ct,cosine,table
idmlinitiative.resources.dtds.aida22.impl.IDTypeImpl.Unmarshaller	idml,initiative,resources,dtds,aida,22,impl,IDType,Impl,Unmarshaller
iff	iff
ijintArrayame	ij,int,Array,ame
illegalNums	illegal,Nums
image1.ImageMatrix.ty	image,1,Image,Matrix,ty
image_proc_source_size	image,proc,source,size
imgHeight	img,Height
imhand	im,hand
inFERange	in,FE,Range
inPathLen	in,Path,Len
in_conns.remove	in,conns,remove
incRU	inc,RU
inchesStr	inches,Str
includedTocFile	included,Toc,File
includes_AST_in	includes,AST,in
increasedMaxValue	increased,Max,Value
indFullresPath	ind,Full,res,Path
indexOpId	index,Op,Id
index_rtx	index,rtx
info.m_prio	info,m,prio
info.magnolia.cms.beans.runtime.Document	info,magnolia,cms,beans,runtime,Document
info.reflength	info,ref,length
ingredient_check	ingredient,check
initConvertorOrderId	init,Convertor,Order,Id
initDBWishlists	init,DB,Wish,lists
initImageBuffer	init,Image,Buffer
initShowInMarkableSelectorPopupMenu	init,Show,In,Markable,Selector,Popup,Menu
initVtbl	init,V,tbl
init_g16_i	init,g,16,i
init_outer_loop	init,outer,loop
init_q_auth_2	init,q,auth,2
init_reg_q_close	init,reg,q,close
init_reply_lookup_names	init,reply,lookup,names
initarea	init,area
initialClearApars	initial,Clear,Apars
initialConnectionSql	initial,Connection,Sql
initialJavaColor	initial,Java,Color
innerEnum	inner,Enum
inst.step_matrix.yx	inst,step,matrix,yx
int_hold	int,hold
integrity.interfaces.ClientServerCommunication	integrity,interfaces,Client,Server,Communication
interdata	inter,data
intra_only	intra,only
ioBuffer	io,Buffer
ioOid	io,O,id
ipaddr_set	ipaddr,set
ipcServiceConstructor	ipc,Service,Constructor
ipchat.info.infoFrame	ip,chat,info,info,Frame
iquant_intra_m2	iquant,intra,m,2
iquery	i,query
irpd_getservbyname	irpd,get,serv,by,name
isDirURI	is,Dir,URI
isIgnoreLoginState	is,Ignore,Login,State
isMaxnumingroupModified	is,Max,num,in,group,Modified
isTrueLeftFourgramPresent	is,True,Left,Four,gram,Present
isValidJDBCType	is,Valid,JDBC,Type
isapi_lookup	is,api,lookup
isaplot	is,a,plot
isldvowel	is,ld,vowel
iso_xmit_handler	iso,xmit,handler
issuerCN	issuer,CN
issuerSHA1KeyHash.len	issuer,SHA,1,Key,Hash,len
iswrite	is,write
it.tidalwave.bluemarine.text.APEXApertureFormat	it,tidal,wave,blue,marine,text,APEX,Aperture,Format
itemLast	item,Last
itemnr	item,nr
iused	iused
jace.proxygen	jace,proxy,gen
jadEncoding	jad,Encoding
java	java
java_class_or_instance	java,class,or,instance
java_entry	java,entry
javax.jms.InvalidDestinationException	javax,jms,Invalid,Destination,Exception
javax.management.remote.rmi	javax,management,remote,rmi
jboss.jmx.connector.rmi.RMIConnectorImpl	jboss,jmx,connector,rmi,RMI,Connector,Impl
jcbDocumentTypeActionPerformed	jcb,Document,Type,Action,Performed
jdoBeforeUpdate	jdo,Before,Update
jmi_wreset	jmi,w,reset
jmt.framework.gui.table.editors.ButtonCellEditor	jmt,framework,gui,table,editors,Button,Cell,Editor
jpegTags	jpeg,Tags
jpeg_consume_input	jpeg,consume,input
jrenderer	j,renderer
jsTypeTags_	js,Type,Tags
js_Invoke	js,Invoke
jsd_GetPropertyVarArgSlot	jsd,Get,Property,Var,Arg,Slot
jsd_IsValuePrimitive	jsd,Is,Value,Primitive
jserv_pool	jserv,pool
jshortArray	j,short,Array
jsoSourceFolder	jso,Source,Folder
jsystray	j,sys,tray
jwo	jwo
kBoPoMoFoOrderIdCID	k,Bo,Po,Mo,Fo,Order,Id,CID
kCImapHostSessionList	k,CI,map,Host,Session,List
kCurrentCWPanelListVersion	k,Current,CW,Panel,List,Version
kDOMImplementationCID	k,DOM,Implementation,CID
kFirstDirSize	k,First,Dir,Size
kFontSizeKTable	k,Font,Size,KTable
kHeavenlyStemOrderIdCID	k,Heavenly,Stem,Order,Id,CID
kIDataFlavor	k,IData,Flavor
kInitSavePageDelay	k,Init,Save,Page,Delay
kInputStreamChannelCID	k,Input,Stream,Channel,CID
kMsgAccountManagerCID	k,Msg,Account,Manager,CID
kNC_Description	k,NC,Description
kSpacesForATab	k,Spaces,For,ATab
kSqrChar	k,Sqr,Char
kTelugu	k,Telugu
kaboom	kaboom
karg	karg
keaParams.originatorKEAKey.len	kea,Params,originator,KEA,Key,len
kerror	k,error
keyChangwat	key,Changwat
key_derive	key,derive
keysToDelete	keys,To,Delete
keytext	key,text
kmap	k,map
lad_fs.total	lad,fs,total
lame_get_lowpassfreq	lame,get,low,pass,freq
langKannada	lang,Kannada
langTagalog	lang,Tagalog
lang_list	lang,list
lastStartPosMatch	last,Start,Pos,Match
lastTimeTick	last,Time,Tick
last_label_ruid	last,label,ruid
lblCounter	lbl,Counter
lcpFragmentId	lcp,Fragment,Id
lcpPtr.i	lcp,Ptr,i
ldap_err2string	ldap,err,2,string
leitchdev	leitch,dev
lenOfHeader	len,Of,Header
lft_rb	lft,rb
libjava	lib,java
limitPente	limit,Pente
linktooltip	link,tooltip
lis	lis
lister_print_horizontal	lister,print,horizontal
loadPGN	load,PGN
loadTextureManager	load,Texture,Manager
localQDefaultTriggerMsgPriority	local,QDefault,Trigger,Msg,Priority
local_freed_mem	local,freed,mem
lockFileCFURL	lock,File,CFURL
logBlendFunc	log,Blend,Func
loginTabPane	login,Tab,Pane
logval_status	log,val,status
lookupProtocols	lookup,Protocols
loopinfo	loop,info
lowPriority	low,Priority
lowbits	low,bits
lpc10.dec	lpc,10,dec
lsa_io_r_lookup_names	lsa,io,r,lookup,names
lsa_io_r_query_info2	lsa,io,r,query,info,2
lum_green_weight	lum,green,weight
lum_mean	lum,mean
lunch_defendj	lunch,defend,j
luxor.swing	luxor,swing
mBackgroundYPosition	m,Background,Y,Position
mComputedMinWidth	m,Computed,Min,Width
mDOMEventLevel	m,DOM,Event,Level
mDbgLen	m,Dbg,Len
mDefaultNamespaceID	m,Default,Namespace,ID
mDeque.mSize	m,Deque,m,Size
mEnvironmentalistNb	m,Environmentalist,Nb
mHTMLBindingStr	m,HTML,Binding,Str
mIDAttributeAtom	m,ID,Attribute,Atom
mJarFile	m,Jar,File
mLenBuf	m,Len,Buf
mMozAreaClosestParent	m,Moz,Area,Closest,Parent
mMozWindowWidget	m,Moz,Window,Widget
mNKeys	m,N,Keys
mNumItems	m,Num,Items
mPACURL	m,PAC,URL
mPICSTreeRatings	m,PICS,Tree,Ratings
mPath.mLen	m,Path,m,Len
mPropertyCount	m,Property,Count
mReqUploadStreamLength	m,Req,Upload,Stream,Length
mSpec.vRefNum	m,Spec,v,Ref,Num
mStartCData	m,Start,CData
mStyleInvalid	m,Style,Invalid
mSubType	m,Sub,Type
mSysPrefs	m,Sys,Prefs
mTargetSpec.vRefNum	m,Target,Spec,v,Ref,Num
mWyciwygChannel	m,Wyciwyg,Channel
m_MarginHeaderFooterTab.m_HeaderRightText	m,Margin,Header,Footer,Tab,m,Header,Right,Text
m_ToolTip.m_hWnd	m,Tool,Tip,m,h,Wnd
m_bDetectZlibMemoryLeaks	m,b,Detect,Zlib,Memory,Leaks
m_bFilenameMode	m,b,File,name,Mode
m_bGPLEvildoer	m,b,GPL,Evil,doer
m_bircsoundevents	m,birc,sound,events
m_btname	m,bt,name
m_buttoncount	m,button,count
m_cdCur.i	m,cd,Cur,i
m_charCommonMax	m,char,Common,Max
m_crSelectedTextColor	m,cr,Selected,Text,Color
m_csBtn1Text	m,cs,Btn,1,Text
m_ctrlUpdateServerFrm	m,ctrl,Update,Server,Frm
m_curFolderDB	m,cur,Folder,DB
m_errorstring	m,error,string
m_firstExecutedScanOp	m,first,Executed,Scan,Op
m_iMaxChatHistory	m,i,Max,Chat,History
m_iSentMoreReq	m,i,Sent,More,Req
m_mozstatus	m,moz,status
m_nSrcTab	m,n,Src,Tab
m_namespaceSupport	m,namespace,Support
m_nsCard	m,ns,Card
m_originalPhysicalUri	m,original,Physical,Uri
m_pfn_qglCallLists	m,pfn,qgl,Call,Lists
m_pfn_qglTexCoord2f	m,pfn,qgl,Tex,Coord,2,f
m_pk2len	m,pk,2,len
m_preSetItem	m,pre,Set,Item
m_rcMethodLbl.top	m,rc,Method,Lbl,top
m_sLDAPSearchBase	m,s,LDAP,Search,Base
m_sizeHdrImgListIcon.cy	m,size,Hdr,Img,List,Icon,cy
m_strHost	m,str,Host
m_uReqStart	m,u,Req,Start
m_wndEvents	m,wnd,Events
mac_error	mac,error
makeConnectString	make,Connect,String
makeSvgFile	make,Svg,File
make_const_array	make,const,array
manager_ph_control_block	manager,ph,control,block
mapFriend	map,Friend
mappedUiString.autoSurround	mapped,Ui,String,auto,Surround
marshallState	marshall,State
marshalledRegs	marshalled,Regs
mask.ccolor.pattern	mask,c,color,pattern
matchArg	match,Arg
max.setLongValue	max,set,Long,Value
maxLeafToRootPath	max,Leaf,To,Root,Path
maxNoOfFiredTriggers	max,No,Of,Fired,Triggers
max_coords	max,coords
max_cpuid	max,cpu,id
max_label	max,label
max_portals	max,portals
max_str	max,str
maxdy	max,dy
maxmobp	maxmobp
maxstacksize	max,stack,size
maybe_cc0_setter	maybe,cc,0,setter
maybepermanent_obstack	maybe,permanent,ob,stack
md.waiter_sem	md,waiter,sem
md3Surface_t	md,3,Surface,t
mdef.operation	m,def,operation
mdia.minf.stbl.stsz.sample_size	mdia,minf,stbl,stsz,sample,size
mec.dwSampleRate	mec,dw,Sample,Rate
mechanism.ulParameterLen	mechanism,ul,Parameter,Len
memFullErr	mem,Full,Err
memPercent	mem,Percent
mem_field_header_get_len	mem,field,header,get,len
memsize	mem,size
menu_open_new_cb	menu,open,new,cb
menubitmap_s	menu,bitmap,s
menuitem	menu,item
messageCtchar.getValueLength	message,Ct,char,get,Value,Length
metaKeyArg	meta,Key,Arg
mgcp_reload	mgcp,reload
mgr_next_row	mgr,next,row
mime_ss	mime,ss
minResidualCapacity	min,Residual,Capacity
min_max_arg_item	min,max,arg,item
minplayers	min,players
mixmonitor_flags	mix,monitor,flags
mk.fsgrep.util.thread	mk,fs,grep,util,thread
mng_ani_trnsp	mng,ani,trnsp
mng_display_rgb8_a8	mng,display,rgb,8,a,8
mng_init_idx1_ni	mng,init,idx,1,ni
mng_magnify_y	mng,magnify,y
mng_pchar	mng,p,char
mng_processsave	mng,process,save
mng_store_jpeg_ga8	mng,store,jpeg,ga,8
mnglcms_freetransform	mngl,cms,free,transform
mod.mod_op	mod,mod,op
modifyFreeInodesCount	modify,Free,I,nodes,Count
moduleDir	module,Dir
morkCh_kN	mork,Ch,k,N
morkMagic_kThumb	mork,Magic,k,Thumb
morseCoder	morse,Coder
mp4ff_get_track_type	mp,4,ff,get,track,type
mpeg2_dc_prec	mpeg,2,dc,prec
mpeg3_aa_cs	mpeg,3,aa,cs
mpeg3_bandInfo	mpeg,3,band,Info
mpeg3demux_movie_size	mpeg,3,demux,movie,size
mpeg_quant	mpeg,quant
mpegts_demux	mpeg,ts,demux
mprLogPagePtr	mpr,Log,Page,Ptr
mq_mess.PROC_NR	mq,mess,PROC,NR
msgChunk	msg,Chunk
msgIsInLocalCache	msg,Is,In,Local,Cache
msgPriority	msg,Priority
msgwin	msg,win
msup_	msup
mtcm	mtcm
mutation.mAttrName	mutation,m,Attr,Name
myDialog.m_flagvalue	my,Dialog,m,flag,value
myPDayAL	my,PDay,AL
mySameKeyspaceList	my,Same,Keyspace,List
my_uncompress	my,uncompress
mysql_kill	mysql,kill
mysql_rollback	mysql,rollback
myten	my,ten
naarani.Design.Table	naarani,Design,Table
nargv	nargv
nativeFolderName	native,Folder,Name
naturalLogBase	natural,Log,Base
nbrTableCols	nbr,Table,Cols
ndbcluster_find_files	ndb,cluster,find,files
need_compare	need,compare
negative_ok	negative,ok
net.matuschek.util.ByteBuffer	net,matuschek,util,Byte,Buffer
net.sf.fixtag.app	net,sf,fix,tag,app
net.sf.pdune.client.dto.CommonUserDTO	net,sf,pdune,client,dto,Common,User,DTO
net.sf.plazma.rcp.swt.forms	net,sf,plazma,rcp,swt,forms
net.sf.rej.java.instruction.ParameterType	net,sf,rej,java,instruction,Parameter,Type
net.sf.signs.gates.BTS4	net,sf,signs,gates,BTS,4
net.sourceforge.barbecue.env.HeadlessEnvironment	net,sourceforge,barbecue,env,Headless,Environment
net.sourceforge.island.authentication.AuthenticationException	net,sourceforge,island,authentication,Authentication,Exception
net.sourceforge.jt673.joules	net,sourceforge,jt,673,joules
net.sourceforge.ojb2hbm.OJB2Hbm	net,sourceforge,ojb,2,hbm,OJB,2,Hbm
net.sourceforge.squirrel_sql.plugins.oracle.expander.SchemaExpander	net,sourceforge,squirrel,sql,plugins,oracle,expander,Schema,Expander
networkOptionsInfo.display.string	network,Options,Info,display,string
newChemBond	new,Chem,Bond
newCirc	new,Circ
newExtnValue	new,Extn,Value
newInsertPosRect	new,Insert,Pos,Rect
newStartupService	new,Startup,Service
newStreamFilterAction	new,Stream,Filter,Action
new_sublist	new,sublist
newlnf	new,lnf
newopt.default_charset	new,opt,default,char,set
nextProcessPsn.lowLongOfPSN	next,Process,Psn,low,Long,Of,PSN
nextTakeOverptr	next,Take,Over,ptr
nextfield	next,field
nextfreeoverrec	next,free,over,rec
nfCompRep	nf,Comp,Rep
nglGetVertexAttribArrayObjectfvATI	ngl,Get,Vertex,Attrib,Array,Object,fv,ATI
nmemb	n,memb
nnContact	nn,Contact
no_trans_update	no,trans,update
nodestateUnits.addElement	node,state,Units,add,Element
nodevalues	node,values
notQButton	not,Q,Button
notdef_index	not,def,index
nowinusec	now,in,use,c
npos	n,pos
nr_AppendDesc	nr,Append,Desc
nsAString::char_type	ns,A,String,char,type
nsAsciiToUnicodeConstructor	ns,Ascii,To,Unicode,Constructor
nsCSSValueListSH	ns,CSS,Value,List,SH
nsCaseConversionImp2	ns,Case,Conversion,Imp,2
nsCopyFileMessageType	ns,Copy,File,Message,Type
nsDOMEventGroup	ns,DOM,Event,Group
nsDOMEventRTTearoff	ns,DOM,Event,RT,Tear,off
nsDefaultSOAPEncoding_1_2	ns,Default,SOAP,Encoding,1,2
nsDequeFunctor	ns,Deque,Functor
nsDeviceContextSpecFactoryMac	ns,Device,Context,Spec,Factory,Mac
nsDocumentType	ns,Document,Type
nsDrawingSurfacePh	ns,Drawing,Surface,Ph
nsFastLoadMuxedDocumentInfo	ns,Fast,Load,Muxed,Document,Info
nsFontGTKUserDefined	ns,Font,GTK,User,Defined
nsGenericHTMLContainerFormElement	ns,Generic,HTML,Container,Form,Element
nsHTMLOListElement	ns,HTML,OList,Element
nsIAbView	ns,I,Ab,View
nsIAboutModule	ns,I,About,Module
nsILocaleFactory	ns,I,Locale,Factory
nsINativeComponentLoader	ns,I,Native,Component,Loader
nsIRDFNode	ns,IRDF,Node
nsIScriptEventHandlerOwner	ns,I,Script,Event,Handler,Owner
nsIXPTLoader	ns,IXPT,Loader
nsIconProtocolHandlerConstructor	ns,Icon,Protocol,Handler,Constructor
nsImapOfflineToOnlineCopy	ns,Imap,Offline,To,Online,Copy
nsInsertPlaintextCommand	ns,Insert,Plain,text,Command
nsKeyPairInfoStr	ns,Key,Pair,Info,Str
nsLDAPSSLConnect	ns,LDAP,SSL,Connect
nsMathMLmoverFrame	ns,Math,ML,mover,Frame
nsMdbTableEnumerator	ns,Mdb,Table,Enumerator
nsMenuX	ns,Menu,X
nsMouseMove	ns,Mouse,Move
nsMsgAccountManagerDataSource	ns,Msg,Account,Manager,Data,Source
nsMsgFilterMotion	ns,Msg,Filter,Motion
nsOutputStreamReadyEvent	ns,Output,Stream,Ready,Event
nsPasteNoFormattingCommand	ns,Paste,No,Formatting,Command
nsPluginDocReframeEvent	ns,Plugin,Doc,Reframe,Event
nsSOCKSIOLayerAcceptRead	ns,SOCKS,IO,Layer,Accept,Read
nsSelectionCommandsBase	ns,Selection,Commands,Base
nsSharableString::shared_buffer_handle_type	ns,Sharable,String::shared,buffer,handle,type
nsSingleSignOnProfileObserver	ns,Single,Sign,On,Profile,Observer
nsTableCellReflowState	ns,Table,Cell,Reflow,State
nsTableOuterFrame	ns,Table,Outer,Frame
nsTemplateMatchRefSet	ns,Template,Match,Ref,Set
nsTextEditorCompositionListener	ns,Text,Editor,Composition,Listener
nsUnicharStreamLoader	ns,Unichar,Stream,Loader
nsUnicodeToBIG5HKSCSConstructor	ns,Unicode,To,BIG,5,HKSCS,Constructor
nsUnicodeToBIG5NoAscii	ns,Unicode,To,BIG,5,No,Ascii
nsVoidBTree::Path	ns,Void,BTree::Path
nsWriteUnicharSegmentFun	ns,Write,Unichar,Segment,Fun
nsXULTabAccessible	ns,XUL,Tab,Accessible
ns_log_eventlib	ns,log,event,lib
ns_viid	ns,vi,id
nsldapi_close_connection	ns,ldap,i,close,connection
nsocks	n,socks
nss	nss
nssCKFWSession_DeregisterSessionObject	nss,CKFW,Session,Deregister,Session,Object
nssCryptoContext_FindCertificatesBySubject	nss,Crypto,Context,Find,Certificates,By,Subject
nssPKIXAttribute_SetType	nss,PKIX,Attribute,Set,Type
ntimesString	n,times,String
ntriangoli	n,triang,oli
ntv	ntv
nu.fw.jeti.plugins.filetransfer.SendFileProgress	nu,fw,jeti,plugins,file,transfer,Send,File,Progress
numLeaves	num,Leaves
numOfRootChoreos	num,Of,Root,Choreos
numPerPage	num,Per,Page
numTables	num,Tables
numTargetTables	num,Target,Tables
num_deaths	num,deaths
num_fixed_sizes	num,fixed,sizes
num_hi_sig	num,hi,sig
num_syncword	num,sync,word
numberoferrorgroups	number,of,error,groups
o.f_stringarray	o,f,string,array
oDontFeedMe	o,Dont,Feed,Me
oWPUB	o,WPUB
objectViewButtonActionPerformed	object,View,Button,Action,Performed
objectcontact	object,contact
obproxyfound	ob,proxy,found
ocspCertStatus_revoked	ocsp,Cert,Status,revoked
ocsp_FinishDecodingSingleResponses	ocsp,Finish,Decoding,Single,Responses
ofnA	ofn,A
og.header	og,header
ogg_iformat	ogg,i,format
oldMsgId	old,Msg,Id
oldPosOnCurrentLine	old,Pos,On,Current,Line
oldRefnum	old,Ref,num
oldTrashNameUtf7	old,Trash,Name,Utf,7
old_preload_size	old,preload,size
oldportal.objectbuilder.document.cpp.editors.ClassMethodPanel	old,portal,object,builder,document,cpp,editors,Class,Method,Panel
omin	omin
omodes	o,modes
one_fn	one,fn
opArguments	op,Arguments
opLocalClock	op,Local,Clock
opcode_function_new	op,code,function,new
openb	open,b
openwfe.org.net	open,wfe,org,net
opt_BinaryDER	opt,Binary,DER
opt_search_plan	opt,search,plan
optflag	opt,flag
ordre.forcePropulseurArriere	ordre,force,Propulseur,Arriere
ordresMobiles_	ordres,Mobiles
oreq	o,req
orfs	orfs
org.amberarcher.os	org,amber,archer,os
org.apache.anteater.test.XMLDocument	org,apache,anteater,test,XML,Document
org.apache.poi.hssf.usermodel.TestCellStyle	org,apache,poi,hssf,usermodel,Test,Cell,Style
org.apache.slide.common.ServiceAccessException	org,apache,slide,common,Service,Access,Exception
org.apache.tools.ant.taskdefs.condition.Http	org,apache,tools,ant,task,defs,condition,Http
org.apache.turbine.flux.modules.actions.group	org,apache,turbine,flux,modules,actions,group
org.bouncycastle.asn1.DERBoolean	org,bouncy,castle,asn,1,DER,Boolean
org.bouncycastle.crypto.engines.NullEngine	org,bouncy,castle,crypto,engines,Null,Engine
org.bouncycastle.jce.cert.PKIXCertPathValidatorResult	org,bouncy,castle,jce,cert,PKIX,Cert,Path,Validator,Result
org.centricware.storage.controller.guide.MenuController	org,centricware,storage,controller,guide,Menu,Controller
org.columba.calendar.config.api.ICalendarList	org,columba,calendar,config,api,ICalendar,List
org.dancres.blitz.remote.debug	org,dancres,blitz,remote,debug
org.dellroad.jc.cgen.analysis	org,dell,road,jc,c,gen,analysis
org.eclipse.jdt.core.IParent	org,eclipse,jdt,core,IParent
org.eclipse.team.core.diff.IThreeWayDiff	org,eclipse,team,core,diff,IThree,Way,Diff
org.emulinker.kaillera.pico	org,emulinker,kaillera,pico
org.hermes.networks.jxta.messaging.JxtaGetDataRequestMessage	org,hermes,networks,jxta,messaging,Jxta,Get,Data,Request,Message
org.htmlencoder.factory	org,html,encoder,factory
org.hyperic.hq.auth	org,hyperic,hq,auth
org.hyperic.hq.measurement.shared.CategoryValue	org,hyperic,hq,measurement,shared,Category,Value
org.imemex.componentmappings.content.fsreplica	org,i,memex,component,mappings,content,fs,replica
org.jamocha.gui.tab.FunctionsPanel	org,jamocha,gui,tab,Functions,Panel
org.jboss.virtual.plugins.vfs.helpers.SuffixesExcludeFilter	org,jboss,virtual,plugins,vfs,helpers,Suffixes,Exclude,Filter
org.jfree.util.SortOrder	org,j,free,util,Sort,Order
org.jibx.binding.model.DefinitionContext	org,jibx,binding,model,Definition,Context
org.jruby.lexer.yacc.SourcePosition	org,jruby,lexer,yacc,Source,Position
org.jsecurity.context.factory.SecurityContextFactory	org,jsecurity,context,factory,Security,Context,Factory
org.jsenna.gridMenu.generators.GeneratorInterface	org,jsenna,grid,Menu,generators,Generator,Interface
org.jvnet.jaxb.reflection.model.runtime.RuntimeTypeInfoSet	org,jvnet,jaxb,reflection,model,runtime,Runtime,Type,Info,Set
org.ksmsa.richDoc.bibliography.types.BibType	org,ksmsa,rich,Doc,bibliography,types,Bib,Type
org.mars_sim.msp.simulation.IntPoint	org,mars,sim,msp,simulation,Int,Point
org.mimosa.www.TechXMLV3_1.mim_5001_05.CharYN	org,mimosa,www,Tech,XMLV,3,1,mim,5001,05,Char,YN
org.newsql.antlr.CharStreamException	org,new,sql,antlr,Char,Stream,Exception
org.opengroupware.jogi.connect.Connection	org,open,groupware,jogi,connect,Connection
org.ourgrid.gridmachine.exception.UnableToExecuteException	org,our,grid,grid,machine,exception,Unable,To,Execute,Exception
org.outerj.daisy.doctaskrunner.clientimpl	org,outer,j,daisy,doc,task,runner,client,impl
org.outerj.daisy.sync.mapping.EntityMapping.MappedAttribute	org,outer,j,daisy,sync,mapping,Entity,Mapping,Mapped,Attribute
org.pi4soa.designer.types.figures.SimpleTypeFigure	org,pi,4,soa,designer,types,figures,Simple,Type,Figure
org.pi4soa.service.DefaultIdentity	org,pi,4,soa,service,Default,Identity
org.schmant.report.StdoutReportFactory	org,schmant,report,Stdout,Report,Factory
org.springframework.web.context.support.ServletContextResourceLoader	org,spring,framework,web,context,support,Servlet,Context,Resource,Loader
org.tagunit.tagext.display	org,tag,unit,tag,ext,display
org.touchupweb.system.UpdaterLauncher	org,touchupweb,system,Updater,Launcher
org.umber.bellows.IDatumTransformer	org,umber,bellows,IDatum,Transformer
org.xmlcrawler.iquery.QueryStructure	org,xmlcrawler,iquery,Query,Structure
orgLineColor	org,Line,Color
origArtOId	orig,Art,O,Id
orig_to	orig,to
originalVartype	original,Var,type
os2.usWidthClass	os,2,us,Width,Class
os_file_closedir	os,file,close,dir
osmsDvAlgorithmManager	osms,Dv,Algorithm,Manager
other_expr	other,expr
otherowners	other,owners
outBuf.mBuf_Fill	out,Buf,m,Buf,Fill
outIfaceFuncImpl	out,Iface,Func,Impl
out_isatty	out,isatty
out_left_diff	out,left,diff
outcur	out,cur
outend	out,end
outpos	out,pos
outputOrgs	output,Orgs
outputYMin	output,Y,Min
ovalrect_node	oval,rect,node
p2absln	p,2,abs,ln
pIAdviseSink	p,IAdvise,Sink
pIDispParent	p,IDisp,Parent
pNewFilter	p,New,Filter
pOdDescrProperty	p,Od,Descr,Property
pSockProvServ	p,Sock,Prov,Serv
pUnkObject	p,Unk,Object
pVerifier	p,Verifier
p_cmdNumber	p,cmd,Number
pac_io_krb_attrs	pac,io,krb,attrs
painelNCasos	painel,N,Casos
pango_coverage_new	pango,coverage,new
paper_width_in_twips	paper,width,in,twips
param.res_length	param,res,length
param.tmpdir	param,tmp,dir
paramArg.isNull	param,Arg,is,Null
paramOrdinal	param,Ordinal
paramParseFile	param,Parse,File
param_check_password	param,check,password
param_usage	param,usage
params.CalGrayProfile	params,Cal,Gray,Profile
params.def	params,def
params.use_ghits	params,use,g,hits
parmno	parm,no
parseDefLine	parse,Def,Line
parseDocumentElement	parse,Document,Element
parseIntArrayToString	parse,Int,Array,To,String
partOutLen	part,Out,Len
partitionEntryLBA.length	partition,Entry,LBA,length
passoL	passo,L
passwordTemplate	password,Template
pasv_addr	pasv,addr
pcmret	pcm,ret
pcr	pcr
pcur_receive	pcur,receive
pcx_ega_palette	pcx,ega,palette
pdf14_mark_procs	pdf,14,mark,procs
pdf_begin_aside	pdf,begin,aside
pdf_font_descriptor_values_t	pdf,font,descriptor,values,t
perform_worklist	perform,worklist
pflg	p,flg
pfnSetProcessDefaultLayout	pfn,Set,Process,Default,Layout
pgcookie	pg,cookie
ph.m_old_prepare_page_reference	ph,m,old,prepare,page,reference
pharerouge.utils.InterruptableInputStream	pharerouge,utils,Interruptable,Input,Stream
phex.xml.sax.DElement	phex,xml,sax,D,Element
pixbufLock	pix,buf,Lock
pkcs11PinArg	pkcs,11,Pin,Arg
plan_guru_dft_r2c	plan,guru,dft,r,2,c
plugindialog_moduleattach_y	plugin,dialog,module,attach,y
pmullw	p,mull,w
pn_max	pn,max
png_set_sBIT	png,set,s,BIT
pnlEsEcl_btnOutDir.setEnabled	pnl,Es,Ecl,btn,Out,Dir,set,Enabled
popupOnMove	popup,On,Move
portTypeNamespace	port,Type,Namespace
prFileNo	pr,File,No
pr_previous	pr,previous
prec_sym_name.value	prec,sym,name,value
pred_ctime	pred,c,time
predict_16x16_dc_top	predict,16,x,16,dc,top
prefColorTree	pref,Color,Tree
pref_name	pref,name
pref_saveArgs	pref,save,Args
prefsData.verbose	prefs,Data,verbose
premon	pre,mon
prepareUtilTransaction	prepare,Util,Transaction
presentationFacade	presentation,Facade
prev.pivot_x	prev,pivot,x
prevDescent	prev,Descent
prevGcpConnect	prev,Gcp,Connect
prevRef	prev,Ref
prevRowFrame	prev,Row,Frame
prev_pos	prev,pos
previous_ch	previous,ch
primary_gid	primary,gid
printDROP_TRIG_CONF	print,DROP,TRIG,CONF
printPreBlockExpression	print,Pre,Block,Expression
print_ident_comments	print,ident,comments
print_unexp	print,unexp
printdir	print,dir
probPickI	prob,Pick,I
proc_table	proc,table
process_nmb_request	process,nmb,request
procnames_start_line	proc,names,start,line
productUPDATESQL	product,UPDATE,SQL
profDebutPlage	prof,Debut,Plage
propagateNetBackwardQuickprop	propagate,Net,Backward,Quick,prop
prs_append_some_prs_data	prs,append,some,prs,data
ps.com_col	ps,com,col
psFGList	ps,FG,List
psf_get_filelen_fd	psf,get,file,len,fd
psname	ps,name
pstoreDir	p,store,Dir
pszPath	psz,Path
ptr_passwd	ptr,passwd
publicationUrl	publication,Url
pulCount	pul,Count
pusWrappedKeyLen	pus,Wrapped,Key,Len
put_pixels16_mlib	put,pixels,16,m,lib
pwce	pwce
py_tdb_hnd_first_key	py,tdb,hnd,first,key
py_tdb_hnd_has_key	py,tdb,hnd,has,key
q1_numfaces	q,1,num,faces
q3_dmodels	q,3,d,models
qaWebBrowser	qa,Web,Browser
qe.last_pos_said	qe,last,pos,said
qev	qev
qglMapGrid2f	qgl,Map,Grid,2,f
qglTexGenfv	qgl,Tex,Genfv
qosReportsPreprocessor.incredibleReportsList	qos,Reports,Preprocessor,incredible,Reports,List
qpix_avg	q,pix,avg
que_names	que,names
queryEncodingStr	query,Encoding,Str
query_md_blob_data_req	query,md,blob,data,req
questKill	quest,Kill
quicktime_edts_t	quicktime,edts,t
quicktime_flush_vcodec	quicktime,flush,vcodec
qwglDeleteContext	qwgl,Delete,Context
rCombo.bottom	r,Combo,bottom
r_has_stype	r,has,stype
randHash	rand,Hash
randomNumberGen	random,Number,Gen
rcClient.bottom	rc,Client,bottom
rcFrame.width	rc,Frame,width
rcchk_	rc,chk
rcds.length	rcds,length
rcpts.length	rcpts,length
rcverHostName	rcver,Host,Name
rdfLength	rdf,Length
rdfsn	rdfsn
readExecSrNewMbyte	read,Exec,Sr,New,M,byte
readVCM	read,VCM
read_attack_db	read,attack,db
read_query_buf	read,query,buf
readcmd	read,cmd
reads_colormodel	reads,color,model
realURI	real,URI
recordingfilename	recording,file,name
recursiveNodeTraversal	recursive,Node,Traversal
recv_max_parsed_page_no	recv,max,parsed,page,no
redirectParent	redirect,Parent
redirectorType	redirector,Type
refHdr	ref,Hdr
refQueueInfo	ref,Queue,Info
reflowReasonString	reflow,Reason,String
refreshFavouritesList	refresh,Favourites,List
reg.i_key_boost	reg,i,key,boost
reg_set_table_size	reg,set,table,size
regattempts	reg,attempts
region_ptr	region,ptr
register_agent	register,agent
regmove_time	reg,move,time
reloadreg	reload,reg
remInvMuL	rem,Inv,Mu,L
remote_playlist_delete	remote,playlist,delete
removeAllWpts	remove,All,Wpts
removeBotsMenuInfo.up.width	remove,Bots,Menu,Info,up,width
repos_hooks	repos,hooks
resizerHeight	resizer,Height
resolution_opt	resolution,opt
retText	ret,Text
ret_sub	ret,sub
retco	retco
retried_trans	retried,trans
rev_increment	rev,increment
rgTop	rg,Top
rgb4	rgb,4
rhs.mStartPageNum	rhs,m,Start,Page,Num
rhs2_AST	rhs,2,AST
rightFreedom	right,Freedom
rightObjClass	right,Obj,Class
rightPos	right,Pos
rightRect.height	right,Rect,height
rit	rit
rl_comment_len	rl,comment,len
rl_editing_mode	rl,editing,mode
roid	roid
rollback_by_xid	rollback,by,xid
rollup_make_fields	roll,up,make,fields
rowCopyLen	row,Copy,Len
row_upd_rec_sys_fields_in_recovery	row,upd,rec,sys,fields,in,recovery
rstrmbuf	rs,trm,buf
rtlname	rtl,name
runFlattener	run,Flattener
run_eol_code_value	run,eol,code,value
runiqueId	r,unique,Id
rw_case	rw,case
s3mrtgspeed	s,3,mrtg,speed
sAppShell	s,App,Shell
sBeginLineString	s,Begin,Line,String
sDB_COLUMN	s,DB,COLUMN
sHTMLTagUnicodeName_img	s,HTML,Tag,Unicode,Name,img
sOS_DriveDirectory	s,OS,Drive,Directory
sOnpaint_id	s,On,paint,id
sTextfieldBorderSize.top	s,Text,field,Border,Size,top
sUint16Val	s,Uint,16,Val
s_configs.arrows.generic.y	s,configs,arrows,generic,y
s_options.sound.style	s,options,sound,style
s_playersettings.banner.generic.y	s,player,settings,banner,generic,y
s_rankings.logout.generic.x	s,rankings,logout,generic,x
s_signup.password.generic.type	s,signup,password,generic,type
saga.inout.creation.CreationHandlerImpl	saga,in,out,creation,Creation,Handler,Impl
sampfmt	samp,fmt
sampy	sampy
sandcx	sandcx
saveConfigActionPerformed	save,Config,Action,Performed
saveXTFRInfo	save,XTFR,Info
sball	s,ball
scalar08_float32_i387	scalar,08,float,32,i,387
scalar12_float32_3DNow	scalar,12,float,32,3,DNow
scanKeyinfoFlag	scan,Key,info,Flag
scanLocalref	scan,Local,ref
scattoAllaRisposta	scatto,Alla,Risposta
score_max	score,max
scrConsole	scr,Console
scratchalloc	scratch,alloc
sd.signatureAlgorithm	sd,signature,Algorithm
searchIDToSearch	search,ID,To,Search
searchInfo1.hFileInfo.ioFlFndrInfo.fdLocation.h	search,Info,1,h,File,Info,io,Fl,Fndr,Info,fd,Location,h
searchSiteButtonPk	search,Site,Button,Pk
sec_desc_size	sec,desc,size
sec_pkcs12_destroy_certificate_list	sec,pkcs,12,destroy,certificate,list
sec_print_f	sec,print,f
secmodSlotDataStr	sec,mod,Slot,Data,Str
secondSrcBytes	second,Src,Bytes
secrets_store_ldap_pw	secrets,store,ldap,pw
sect.sct_loyal	sect,sct,loyal
sect_amt	sect,amt
self_subrange	self,subrange
sendFortezzaClientKeyExchange	send,Fortezza,Client,Key,Exchange
sendNdbSttor	send,Ndb,Sttor
serverURILen	server,URI,Len
servermajorversion	server,major,version
serverport	server,port
serviceNameQName	service,Name,QName
service_deregister	service,deregister
setActiveTarget	set,Active,Target
setAffichageSide	set,Affichage,Side
setAfficheDebFin	set,Affiche,Deb,Fin
setBetrAlt	set,Betr,Alt
setDisplayPicutre	set,Display,Picutre
setDontBalanceTextColumns	set,Dont,Balance,Text,Columns
setGCtrl	set,G,Ctrl
setImageResize	set,Image,Resize
setInternalLoc	set,Internal,Loc
setMemberFirstIP	set,Member,First,IP
setPIdNum	set,P,Id,Num
setPaginableFind	set,Paginable,Find
setRendererOpenIcon	set,Renderer,Open,Icon
setRsrc_Name	set,Rsrc,Name
setRunAttributesCB	set,Run,Attributes,CB
setTmChild	set,Tm,Child
setTopLevelGroupCRID	set,Top,Level,Group,CRID
setYAxisLabelsPos	set,Y,Axis,Labels,Pos
setYCoeff	set,Y,Coeff
set_globprec	set,glob,prec
set_io	set,io
set_master_column	set,master,column
sfString.s	sf,String,s
sfcadj	sfc,adj
sfsbhome	sfsb,home
sgf_flush_file	sgf,flush,file
sgf_printboard	sgf,print,board
sha_inner	sha,inner
shared_memory_pos	shared,memory,pos
ship.shp_y	ship,shp,y
should	should
si_3ButtonConfirm	si,3,Button,Confirm
si_DoDialogIfPrefIsOff	si,Do,Dialog,If,Pref,Is,Off
sig_table_nelts	sig,table,n,elts
sincos_bf	sin,cos,bf
single.xmin	single,x,min
size2.cx	size,2,cx
sjg.maze	sjg,maze
sk_X509_push	sk,X,509,push
skel_sys_acl_get_perm	skel,sys,acl,get,perm
skip_bottom	skip,bottom
slin_g723_ex	slin,g,723,ex
slr.fScript	slr,f,Script
smbw_shared_fd	smbw,shared,fd
smilehouse.opensyncro.pipes.component.DestinationIF	smile,house,open,sync,ro,pipes,component,Destination,IF
sndCall.addr.maxlen	snd,Call,addr,max,len
snd_config_set_integer	snd,config,set,integer
snd_ctl_elem_info_get_numid	snd,ctl,elem,info,get,num,id
snd_interval_t	snd,interval,t
snd_mixer_selem_set_capture_volume_range	snd,mixer,selem,set,capture,volume,range
snd_pcm_plugin_drop	snd,pcm,plugin,drop
snd_pcm_route_ttable_entry_t	snd,pcm,route,t,table,entry,t
snd_seq_queue_timer_t	snd,seq,queue,timer,t
snlimit	sn,limit
sns.length	sns,length
sock_info.remote	sock,info,remote
sorButton	sor,Button
spDocHostUIHandler	sp,Doc,Host,UI,Handler
spawn_init	spawn,init
splitToIntArray	split,To,Int,Array
sqlOrderByClause	sql,Order,By,Clause
srcPix	src,Pix
srv_suspend_thread	srv,suspend,thread
srv_time	srv,time
ss.g_idx	ss,g,idx
ssl_InitGather	ssl,Init,Gather
ssl_socket_sendv	ssl,socket,sendv
stHostToPingAddr	st,Host,To,Ping,Addr
stWebSocket.m_pBuf	st,Web,Socket,m,p,Buf
st_cur_offset	st,cur,offset
st_wc_mbytes	st,wc,mbytes
startPoint.y	start,Point,y
startSimulationUpdate	start,Simulation,Update
statement.setURL	statement,set,URL
status.st_ctime	status,st,ctime
stgmedData	stg,med,Data
stockHeight	stock,Height
stopMbyte	stop,Mbyte
strDnsQuery	str,Dns,Query
strFilePaths	str,File,Paths
strIDError	str,ID,Error
strPoint	str,Point
str_AboutNMinutes	str,About,NMinutes
stream.opaque	stream,opaque
stream_hc_state	stream,hc,state
strpos	str,pos
styleSheetFactory	style,Sheet,Factory
svr.peer	svr,peer
swf_write_trailer	swf,write,trailer
swingActions.LAF	swing,Actions,LAF
swpOK	swp,OK
synced	synced
syno	syno
sys_trust_routine_creators	sys,trust,routine,creators
szDrv	sz,Drv
szFileIdiGetRedirect	sz,File,Idi,Get,Redirect
szLeft	sz,Left
tabSuperProfiles	tab,Super,Profiles
tc_ett	tc,ett
tc_log	tc,log
tcl_LogGet	tcl,Log,Get
tcp_print_conn	tcp,print,conn
teardownReports.toArray	tear,down,Reports,to,Array
tech_log_base	tech,log,base
tempBgColor	temp,Bg,Color
tensor_obounds	tensor,obounds
term_mm	term,mm
terraindata.headerinfo.MinimumAltitude	terrain,data,header,info,Minimum,Altitude
testAlphanumericObjectfailedCommit	test,Alphanumeric,Object,failed,Commit
testAverageDistancesOnFfiniteDiameterGraph	test,Average,Distances,On,F,finite,Diameter,Graph
testEjbRemove	test,Ejb,Remove
testEnterJTableHeaderDragAndLeaveByPercentage	test,Enter,JTable,Header,Drag,And,Leave,By,Percentage
testHeightOffsetWGS72	test,Height,Offset,WGS,72
testIsAnnotation	test,Is,Annotation
testLoadClassesFromClasspathSorted	test,Load,Classes,From,Classpath,Sorted
testMetaDataDOM	test,Meta,Data,DOM
testReceivingASpringEvent	test,Receiving,A,Spring,Event
testRmiProxyFactoryBeanWithConnectIOException	test,Rmi,Proxy,Factory,Bean,With,Connect,IOException
testSJISEncoder	test,SJIS,Encoder
testSimple7b	test,Simple,7,b
testValidationMultiFalseNotAllowed	test,Validation,Multi,False,Not,Allowed
testWriteFloat	test,Write,Float
testaddResponsibility	test,add,Responsibility
tests.basic.ResultSetTypesTests.suite	tests,basic,Result,Set,Types,Tests,suite
textToUnicodeInfo	text,To,Unicode,Info
textnode	text,node
textoSuperior	texto,Superior
tfact	t,fact
tftpfolderField	tftp,folder,Field
tgeLocked	tge,Locked
tgseElementptr	tgse,Element,ptr
that.global_block_size	that,global,block,size
theDeathDB.updateFidByPtid	the,Death,DB,update,Fid,By,Ptid
theImpl	the,Impl
theWebServices	the,Web,Services
theend	the,end
theframed	the,framed
themepackLabel	theme,pack,Label
this.GL_ARB_point_parameters	this,GL,ARB,point,parameters
this.allterms_hash	this,all,terms,hash
this.cbSize.setSelectedIndex	this,cb,Size,set,Selected,Index
this.checkboxArticle	this,checkbox,Article
this.cmd_id	this,cmd,id
this.docLangId	this,doc,Lang,Id
this.editableNameField	this,editable,Name,Field
this.field_26_cWordsFtnEnd	this,field,26,c,Words,Ftn,End
this.gcb	this,gcb
this.inetConn.getSelectedIndex	this,inet,Conn,get,Selected,Index
this.load_collection_progress_popup	this,load,collection,progress,popup
this.loginExisted	this,login,Existed
this.maxNumberOfGameConnections	this,max,Number,Of,Game,Connections
this.metaTable	this,meta,Table
this.optionalSuperclassType	this,optional,Superclass,Type
this.oyoahaBackgroundObject	this,oyoaha,Background,Object
this.referencedObjectTimestampMap	this,referenced,Object,Timestamp,Map
this.txtPatientNumberFocusLost	this,txt,Patient,Number,Focus,Lost
this.typeInt	this,type,Int
this.wildcardexclude	this,wildcard,exclude
thunk_IClassFactory_CreateInstance	thunk,I,Class,Factory,Create,Instance
tib_ptib2	tib,ptib,2
timSizeH	tim,Size,H
timeoutIn	timeout,In
timestarted	time,started
timezoneAddr	time,zone,Addr
tm_flush_logfiles	tm,flush,log,files
tmp.m_variant	tmp,m,variant
tmp.opened_tables	tmp,opened,tables
tmpDBKey.data	tmp,DB,Key,data
tmpIIData.endIndex	tmp,II,Data,end,Index
tmpLevelStep	tmp,Level,Step
tmpQ.z	tmp,Q,z
tmpchar	tmp,char
tmpu	tmp,u
tnd.szTip	tnd,sz,Tip
tnntpd.Group	tnntpd,Group
toAbortHandlingLab	to,Abort,Handling,Lab
toQueryExp	to,Query,Exp
tocs	tocs
todayFlexidate	today,Flexi,date
toggleConditionalBreakpoint	toggle,Conditional,Breakpoint
toggleMinPieceSpacing	toggle,Min,Piece,Spacing
tokColon	tok,Colon
tok_info.hardwareVersion.minor	tok,info,hardware,Version,minor
tokv_syslog_lpr	tokv,syslog,lpr
tooltipEl	tooltip,El
total_bytes_rcvd	total,bytes,rcvd
tpltObj.getName	tplt,Obj,get,Name
tr_localaddr	tr,local,addr
track_num	track,num
transfer_RGB_FLOAT_to_YUV444P	transfer,RGB,FLOAT,to,YUV,444,P
transtag	trans,tag
trap_EA_EndRegular	trap,EA,End,Regular
treservations	t,reservations
trigname	trig,name
trivNew	triv,New
trlRelCon	trl,Rel,Con
trx_undo_seg_create	trx,undo,seg,create
try_SetCought	try,Set,Cought
tsscContainerptr	tssc,Container,ptr
tstfillp	tst,fill,p
ttx	ttx
tupleOfTVars	tuple,Of,T,Vars
tw.sphere	tw,sphere
twosided	two,sided
txMode	tx,Mode
txXSLTProcessor	tx,XSLT,Processor
txtMisc	txt,Misc
txtNumRight	txt,Num,Right
typeNS	type,NS
u.A_WhichIO.ut_in_out_put_t_1	u,A,Which,IO,ut,in,out,put,t,1
u.dshare.chn_mask	u,d,share,chn,mask
u.ucclass.startIndex	u,uc,class,start,Index
u2BytesGRPrefix8FCharset	u,2,Bytes,GR,Prefix,8,F,Charset
uAllTimeRequests	u,All,Time,Requests
uClientIP	u,Client,IP
uHeaders	u,Headers
ubmatrix.xbrl.validation.pattern.src.ActionType.DtsQueryPredicateType.QueryPartType	ubmatrix,xbrl,validation,pattern,src,Action,Type,Dts,Query,Predicate,Type,Query,Part,Type
ubody	u,body
uf_space_prespace	uf,space,prespace
ui64TotFileSize	ui,64,Tot,File,Size
uiInfo.uiDC.feederCount	ui,Info,ui,DC,feeder,Count
uiThread	ui,Thread
ui_displMapCOL	ui,displ,Map,COL
ui_displayHelp	ui,display,Help
ui_key_eventPos.x	ui,key,event,Pos,x
ui_setOrientProc	ui,set,Orient,Proc
ui_teamName	ui,team,Name
uid_copy	uid,copy
uk.ac.reload.moonunit.vocab	uk,ac,reload,moonunit,vocab
uk.co.mullsoft.jean.dag.attributes	uk,co,mullsoft,jean,dag,attributes
uk.org.toot.swingui.audioui.mixerui.MixerPanelFactory	uk,org,toot,swing,ui,audio,ui,mixer,ui,Mixer,Panel,Factory
ulScreenY	ul,Screen,Y
undirected	undirected
unescapedUserPass	unescaped,User,Pass
uniStatsPanel	uni,Stats,Panel
uni_workstations	uni,workstations
unihh.informatik.bachmann.cosim.Model_FactoryHelper.read	unihh,informatik,bachmann,cosim,Model,Factory,Helper,read
unix_wild_match	unix,wild,match
unregisterBean	unregister,Bean
unsetFileName	unset,File,Name
unzlocal_DosDateToTmuDate	unz,local,Dos,Date,To,Tmu,Date
updatable_view	updatable,view
updateAllDiffBackgrounds	update,All,Diff,Backgrounds
updatecpu	update,cpu
usage_getdata	usage,get,data
use_aic	use,aic
usec_since_lastframe	usec,since,last,frame
usemap	use,map
userClickText	user,Click,Text
userConn	user,Conn
usr.isBot	usr,is,Bot
usrResults	usr,Results
ut_stats_tag_t	ut,stats,tag,t
utf8_signature	utf,8,signature
uup_height	uup,height
uval.dv	uval,dv
v4l2_parm.parm.capture.capturemode	v,4,l,2,parm,parm,capture,capturemode
va.persistent	va,persistent
validItem	valid,Item
validSValuesAndGenes	valid,S,Values,And,Genes
value_top_sizeof	value,top,size,of
var_defend	var,defend
vargram_defact	var,gram,defact
variables.max_length_for_sort_data	variables,max,length,for,sort,data
varid	var,id
vars_need_expansion	vars,need,expansion
vdrad	vdrad
vec_transpose	vec,transpose
vedit_x	v,edit,x
versionend	version,end
vert_right	vert,right
vframe	v,frame
viewCrs	view,Crs
viewx	view,x
visualizerVector	visualizer,Vector
vlp_job	vlp,job
vmprintfes	vmprintfes
vmx.ssp	vmx,ssp
vpage_buffer_length	v,page,buffer,length
vpix.x	vpix,x
vqgen	vq,gen
vstr	vstr
vtf_user.text	vtf,user,text
vui.i_num_reorder_frames	vui,i,num,reorder,frames
wait_for_io	wait,for,io
wav_w64_format_str	wav,w,64,format,str
wbarg	wbarg
wbdd	wbdd
wcscmp	wcscmp
wcspbrk	wcspbrk
wds	wds
wf.cbSize	wf,cb,Size
wfDetailString	wf,Detail,String
widgets.fpfToggle	widgets,fpf,Toggle
windowspan	window,span
wins_srv_count	wins,srv,count
wndUnderMouse	wnd,Under,Mouse
workbuf_shift	work,buf,shift
worker.billing_last_name	worker,billing,last,name
wqueue	w,queue
wrappedStmt.executeUpdate	wrapped,Stmt,execute,Update
writeCompartment	write,Compartment
writeCustomHTML	write,Custom,HTML
wtype	wtype
x0.oasisNamesTcOpendocumentXmlnsDrawing1.FillImageDocument.FillImage.Show	x,0,oasis,Names,Tc,Opendocument,Xmlns,Drawing,1,Fill,Image,Document,Fill,Image,Show
x264_cabac_t	x264,cabac,t
xGetJobStaus	x,Get,Job,Staus
xcolor.flags	x,color,flags
xgetAutomaticFocus	x,get,Automatic,Focus
xgetColumnWidth	x,get,Column,Width
xltest	xl,test
xmldoc	xml,doc
xpc_proto_proto	xpc,proto,proto
xslUriForKey	xsl,Uri,For,Key
xtVersion	xt,Version
xtest	x,test
xySpace	xy,Space
ycc_rgb_convert	ycc,rgb,convert
yuv_correction_t	yuv,correction,t
yylex	yy,lex
yyz_flex_debug	yyz,flex,debug
yyz_flush_buffer	yyz,flush,buffer
zsub	z,sub
~AggregateTransaction	Aggregate,Transaction
~CodeFragment	Code,Fragment
~DR_FrameTreeNode	DR,Frame,Tree,Node
~MyPrivateData	My,Private,Data
~PolyArea	Poly,Area
~RobotSink	Robot,Sink
~WaveEffect	Wave,Effect
~txSyncCompileObserver	tx,Sync,Compile,Observer
